sa2_name_2021,state_specific_YBFS_no_attended_yes,state_specific_YBFS_no_attended_no,state_specific_YBFS_yes_attended_yes,state_specific_YBFS_yes_attended_no,sa2_code_2021,total_ybfs_no,total_ybfs_yes
Braidwood,4,32,7,57,101021007,36,64
Karabar,19,49,23,82,101021008,68,105
Queanbeyan,19,49,26,113,101021009,68,139
Queanbeyan - East,11,25,22,51,101021010,36,73
Queanbeyan Region,85,187,149,300,NA,272,449
Queanbeyan West - Jerrabomberra,39,92,51,170,101021012,131,221
Bombala,0,46,5,59,101031013,46,64
Cooma,0,48,0,115,101031014,48,115
Cooma Region,0,0,0,0,NA,0,0
Jindabyne - Berridale,3,63,0,78,101031016,66,78
Batemans Bay,0,54,0,104,101041017,54,104
Batemans Bay - South,0,47,0,89,101041018,47,89
Bega - Tathra,0,46,0,131,101041019,46,131
Bega-Eden Hinterland,0,46,0,117,101041020,46,117
Broulee - Tomakin,0,27,0,30,101041021,27,30
Deua - Wadbilliga,0,0,0,0,101041022,0,0
Eden,0,28,0,56,101041023,28,56
Eurobodalla Hinterland,0,13,0,34,101041024,13,34
Merimbula - Tura Beach,0,61,0,111,101041025,61,111
Moruya - Tuross Head,0,53,0,95,101041026,53,95
Narooma - Bermagui,0,70,0,121,101041027,70,121
Goulburn,3,207,11,363,101051539,210,374
Goulburn Region,0,88,6,169,NA,88,175
Yass,5,58,12,104,101061541,63,116
Yass Region,31,70,75,115,NA,101,190
Young,5,111,0,171,101061543,116,171
Young Region,0,86,3,94,NA,86,97
Avoca Beach - Copacabana,0,79,0,147,102011028,79,147
Box Head - MacMasters Beach,0,87,0,165,102011029,87,165
Calga - Kulnura,0,37,0,46,102011030,37,46
Erina - Green Point,0,96,0,202,102011031,96,202
Gosford - Springfield,0,155,0,267,102011032,155,267
Kariong,0,72,0,126,102011033,72,126
Kincumber - Picketts Valley,0,69,0,117,102011034,69,117
Narara,0,67,0,119,102011035,67,119
Niagara Park - Lisarow,0,77,0,149,102011036,77,149
Point Clare - Koolewong,0,55,0,97,102011037,55,97
Saratoga - Davistown,0,71,0,102,102011038,71,102
Terrigal - North Avoca,0,125,4,226,102011039,125,230
Umina - Booker Bay - Patonga,0,227,0,354,102011040,227,354
Wamberal - Forresters Beach,0,97,0,175,102011041,97,175
Woy Woy - Blackwall,0,102,0,156,102011042,102,156
Wyoming,0,117,0,167,102011043,117,167
Bateau Bay - Killarney Vale,0,237,0,417,102021044,237,417
Blue Haven - San Remo,0,124,0,211,102021045,124,211
Budgewoi - Buff Point - Halekulani,0,76,0,146,102021046,76,146
Chittaway Bay - Tumbi Umbi,0,154,0,283,102021047,154,283
Gorokan - Kanwal - Charmhaven,0,167,0,346,102021048,167,346
Jilliby - Yarramalong,0,21,0,50,102021049,21,50
Lake Munmorah - Mannering Park,0,91,0,141,102021050,91,141
Ourimbah - Fountaindale,0,43,0,82,102021051,43,82
Summerland Point - Gwandalan,0,58,0,101,102021052,58,101
The Entrance,0,109,0,213,102021053,109,213
Toukley - Norah Head,0,75,0,152,102021054,75,152
Tuggerah - Kangy Angy,0,51,0,99,102021055,51,99
Warnervale - Wadalba,4,228,0,396,102021056,232,396
Wyong,0,89,0,134,102021057,89,134
Bathurst,0,231,0,357,NA,231,357
Bathurst - East,0,117,0,220,103011059,117,220
Bathurst Region,0,46,0,85,NA,46,85
Oberon,0,29,0,58,103011061,29,58
Condobolin,0,61,0,132,103021062,61,132
Cowra,0,71,0,154,103021063,71,154
Cowra Region,0,35,0,55,NA,35,55
Forbes,0,86,0,194,103021065,86,194
Grenfell,0,34,0,46,103021066,34,46
Parkes (NSW),0,82,0,168,103021067,82,168
Parkes Region,0,27,0,49,NA,27,49
West Wyalong,0,56,0,89,103021069,56,89
Lithgow,0,76,0,167,103031070,76,167
Lithgow Region,0,50,0,103,NA,50,103
Mudgee,3,148,0,265,103031072,151,265
Mudgee Region - East,0,20,0,39,NA,20,39
Mudgee Region - West,0,86,0,173,NA,86,173
Wollangambe - Wollemi,0,0,0,0,103031075,0,0
Blayney,0,73,0,126,103041076,73,126
Orange,0,163,0,274,103041077,163,274
Orange - North,0,222,4,477,103041078,222,481
Orange Region,0,73,0,203,NA,73,203
Grafton,0,148,3,293,104011080,148,296
Grafton Region,0,92,5,205,NA,92,210
Maclean - Yamba - Iluka,0,121,0,207,104011082,121,207
Bellingen,0,53,0,112,104021083,53,112
Coffs Harbour - North,0,163,0,280,104021084,163,280
Coffs Harbour - South,0,90,0,132,104021085,90,132
Coramba - Nana Glen - Bucca,0,29,0,59,104021086,29,59
Dorrigo,0,0,0,0,104021087,0,0
Korora - Emerald Beach,0,92,0,177,104021088,92,177
Sawtell - Boambee,0,151,0,293,104021089,151,293
Urunga,0,37,0,54,104021090,37,54
Woolgoolga - Arrawarra,3,88,4,210,104021091,91,214
Bourke - Brewarrina,0,53,0,66,105011092,53,66
Cobar,0,42,0,63,105011093,42,63
Coonamble,0,41,0,89,105011094,41,89
Nyngan - Warren,0,53,0,96,105011095,53,96
Walgett - Lightning Ridge,0,57,0,120,105011096,57,120
Broken Hill,0,105,0,284,105021097,105,284
Far West,0,12,0,45,105021098,12,45
Coonabarabran,0,46,0,105,105031099,46,105
Dubbo - East,0,97,0,201,105031100,97,201
Dubbo - South,0,207,0,392,105031101,207,392
Dubbo - West,0,106,0,200,105031102,106,200
Dubbo Region,0,47,0,84,NA,47,84
Gilgandra,0,45,0,84,105031104,45,84
Narromine,0,68,0,142,105031105,68,142
Wellington,0,77,0,150,105031106,77,150
Branxton - Greta - Pokolbin,0,168,0,312,106011107,168,312
Cessnock,0,185,0,373,106011108,185,373
Cessnock Region,0,60,0,139,NA,60,139
Dungog,0,126,0,247,106011110,126,247
Kurri Kurri - Abermain,0,199,0,378,106011111,199,378
Singleton,0,132,0,306,106011112,132,306
Singleton Region,0,0,0,0,NA,0,0
Maitland,0,103,0,180,106021114,103,180
Maitland - East,0,242,0,439,NA,242,439
Maitland - North,0,100,0,165,106021116,100,165
Maitland - West,0,292,3,526,NA,292,529
Thornton - Millers Forest,0,168,0,284,106021618,168,284
Anna Bay,0,38,0,68,106031119,38,68
Lemon Tree Passage - Tanilba Bay,0,39,0,84,106031120,39,84
Nelson Bay Peninsula,3,116,0,217,106031121,119,217
Raymond Terrace,0,124,0,254,106031122,124,254
Seaham - Woodville,0,57,0,86,106031123,57,86
Tea Gardens - Hawks Nest,0,16,0,34,106031124,16,34
Williamtown - Medowie - Karuah,0,130,5,252,106031125,130,257
Muswellbrook,0,102,0,197,106041126,102,197
Muswellbrook Region,0,19,0,64,NA,19,64
Scone,0,38,0,104,106041128,38,104
Scone Region,0,49,0,129,NA,49,129
Dapto - Avondale,0,216,0,371,107011131,216,371
Horsley - Kembla Grange,0,170,0,259,107011132,170,259
Port Kembla Industrial,0,0,0,0,107011133,0,0
Unanderra - Mount Kembla,0,143,0,228,107011134,143,228
Berkeley - Lake Heights - Cringila,0,131,0,202,107011545,131,202
Port Kembla - Warrawong,0,79,0,139,107011546,79,139
Windang - Primbee,0,34,0,54,107011547,34,54
Illawarra Catchment Reserve,0,0,0,0,107021135,0,0
Albion Park - Macquarie Pass,0,236,0,358,107031136,236,358
Albion Park Rail,0,56,0,104,107031137,56,104
Kiama,0,64,0,127,107031138,64,127
Kiama Downs - Minnamurra,0,65,0,106,107031139,65,106
Kiama Hinterland - Gerringong,0,64,0,121,107031140,64,121
Shellharbour - Flinders,0,208,0,313,107031141,208,313
Shellharbour - Oak Flats,0,78,0,133,107031142,78,133
Warilla,0,165,0,287,107031143,165,287
Balgownie - Fairy Meadow,0,186,0,319,107041144,186,319
Corrimal - Tarrawanna - Bellambi,0,117,0,227,107041145,117,227
Figtree - Keiraville,0,196,0,356,107041146,196,356
Helensburgh,0,129,0,198,107041147,129,198
Thirroul - Austinmer - Coalcliff,0,87,0,213,107041148,87,213
Woonona - Bulli - Russell Vale,0,192,0,357,107041150,192,357
Wollongong - East,0,57,0,101,107041548,57,101
Wollongong - West,0,119,0,229,107041549,119,229
Bulahdelah - Stroud,0,23,0,60,108011151,23,60
Forster,0,86,0,166,108011152,86,166
Forster-Tuncurry Region,0,34,0,63,NA,34,63
Tuncurry,0,33,0,58,108011154,33,58
Kempsey,0,154,0,206,108021155,154,206
Kempsey Region,0,80,0,96,NA,80,96
Macksville - Scotts Head,0,44,0,81,108021157,44,81
Nambucca Heads,0,46,0,75,108021158,46,75
Nambucca Heads Region,0,75,0,107,NA,75,107
South West Rocks,0,35,0,82,108021160,35,82
Lord Howe Island,0,0,0,4,108031161,0,4
Laurieton - Bonny Hills,0,78,0,208,108041162,78,208
Port Macquarie - East,0,221,0,376,108041619,221,376
Port Macquarie - West,0,157,0,262,108041164,157,262
Port Macquarie Region,0,0,0,0,NA,0,0
Wauchope,0,183,0,251,108041166,183,251
Gloucester,0,27,0,67,108051167,27,67
Old Bar - Manning Point - Red Head,0,109,0,149,108051168,109,149
Taree,0,176,0,317,108051169,176,317
Taree Region,0,66,0,116,NA,66,116
Wingham,0,48,0,63,108051171,48,63
Albury - East,0,206,0,373,109011172,206,373
Albury - North,0,96,0,167,109011173,96,167
Albury - South,0,78,0,167,109011174,78,167
Albury Region,0,113,0,220,NA,113,220
Lavington,0,142,0,256,109011176,142,256
Hay,0,27,0,35,109021177,27,35
Wentworth - Buronga,0,81,0,122,109021178,81,122
Wentworth-Balranald Region,0,34,0,55,109021179,34,55
Corowa,0,28,0,69,109031180,28,69
Corowa Region,0,61,0,123,NA,61,123
Deniliquin,0,69,0,100,109031182,69,100
Deniliquin Region,0,66,0,111,NA,66,111
Moama,0,58,0,106,109031184,58,106
Tocumwal - Finley - Jerilderie,0,70,0,137,109031185,70,137
Armidale,0,162,0,330,110011186,162,330
Armidale Region - North,0,34,0,53,NA,34,53
Armidale Region - South,0,56,0,63,NA,56,63
Walcha,0,33,0,36,110011189,33,36
Glen Innes,0,45,0,91,110021190,45,91
Inverell,0,92,0,208,110021191,92,208
Inverell Region - East,0,46,0,56,NA,46,56
Inverell Region - West,0,36,0,104,NA,36,104
Tenterfield,9,25,8,64,110021194,34,72
Moree,0,89,3,172,110031195,89,175
Moree Region,8,22,6,90,NA,30,96
Narrabri,0,63,0,127,110031197,63,127
Narrabri Region,0,38,0,97,NA,38,97
Gunnedah,0,115,0,195,110041199,115,195
Gunnedah Region,0,47,0,66,NA,47,66
Quirindi,0,46,0,124,110041201,46,124
Tamworth - East,0,161,0,303,110041202,161,303
Tamworth - North,0,136,0,258,110041203,136,258
Tamworth - West,0,65,0,104,110041204,65,104
Tamworth Region,0,166,0,273,NA,166,273
Belmont - Bennetts Green,0,164,0,242,111011206,164,242
Belmont South - Blacksmiths,0,51,0,64,111011207,51,64
Charlestown - Dudley,0,253,0,467,111011208,253,467
Glendale - Cardiff - Hillsborough,0,240,0,414,111011209,240,414
Mount Hutton - Windale,0,77,0,179,111011210,77,179
Redhead,0,29,0,58,111011211,29,58
Swansea - Caves Beach,0,96,0,186,111011212,96,186
Valentine - Eleebana,0,91,0,241,111011213,91,241
Warners Bay - Boolaroo,0,111,0,213,111011214,111,213
Bolton Point - Teralba,0,96,0,152,111021215,96,152
Bonnells Bay - Silverwater,0,81,0,130,111021216,81,130
Edgeworth - Cameron Park,0,185,0,347,111021217,185,347
Morisset - Cooranbong,0,128,0,247,111021218,128,247
Toronto - Awaba,0,108,0,194,111021219,108,194
Wangi Wangi - Rathmines,0,54,0,145,111021220,54,145
West Wallsend - Barnsley - Killingworth,0,63,0,133,111021221,63,133
Adamstown - Kotara,0,174,0,303,111031222,174,303
Beresfield - Hexham,0,61,0,127,111031223,61,127
Hamilton - Broadmeadow,4,83,0,161,111031224,87,161
Lambton - New Lambton,3,151,0,268,111031225,154,268
Maryland - Fletcher - Minmi,0,192,0,343,111031226,192,343
Mayfield - Warabrook,0,148,0,224,111031227,148,224
Merewether - The Junction,0,110,0,212,111031228,110,212
Newcastle - Cooks Hill,0,61,0,87,111031229,61,87
Newcastle Port - Kooragang,0,0,0,0,111031230,0,0
Shortland - Jesmond,0,57,0,140,111031231,57,140
Stockton - Fullerton Cove,3,75,0,124,111031232,78,124
Wallsend - Elermore Vale,0,166,0,305,111031233,166,305
Waratah - North Lambton,0,88,0,170,111031234,88,170
Wickham - Carrington - Tighes Hill,0,73,0,116,111031235,73,116
Ballina,0,117,0,235,112011236,117,235
Ballina Region,0,134,0,243,NA,134,243
Bangalow,0,57,0,109,112011238,57,109
Brunswick Heads - Ocean Shores,0,61,0,130,112011239,61,130
Byron Bay,0,56,0,132,112011240,56,132
Evans Head,0,36,0,72,112011241,36,72
Lennox Head - Skennars Head,0,78,0,158,112011242,78,158
Mullumbimby,0,55,5,124,112011243,55,129
Casino,0,113,0,212,112021244,113,212
Casino Region,0,42,0,106,NA,42,106
Goonellabah,0,132,0,211,112021246,132,211
Kyogle,0,65,0,97,112021247,65,97
Lismore,0,96,0,217,112021248,96,217
Lismore Region,0,106,4,222,NA,106,226
Kingscliff - Fingal Head,7,126,10,145,112031250,133,155
Murwillumbah,0,54,0,119,112031251,54,119
Murwillumbah Region,0,69,0,124,NA,69,124
Pottsville,4,112,13,235,112031253,116,248
Tweed Heads,23,100,51,212,112031254,123,263
Banora Point,10,106,14,184,112031550,116,198
Terranora - North Tumblegum,0,33,3,55,NA,33,58
Tweed Heads South,6,47,0,87,112031552,53,87
Griffith (NSW),0,150,0,333,113011256,150,333
Griffith Region,0,113,0,225,NA,113,225
Leeton,0,65,0,174,113011258,65,174
Narrandera,0,41,0,86,113011259,41,86
Tumbarumba,0,40,0,66,113021260,40,66
Tumut,0,67,0,113,113021261,67,113
Tumut Region,0,30,0,52,NA,30,52
Cootamundra,0,65,0,102,113031263,65,102
Gundagai,0,22,0,63,113031264,22,63
Junee,0,55,0,95,113031265,55,95
Temora,0,48,0,114,113031266,48,114
Wagga Wagga - East,0,126,0,318,113031267,126,318
Wagga Wagga - North,0,77,0,115,113031268,77,115
Wagga Wagga - South,3,232,0,455,113031269,235,455
Wagga Wagga - West,0,88,0,192,113031270,88,192
Wagga Wagga Region,0,210,0,356,NA,210,356
Berry - Kangaroo Valley,0,68,0,115,114011272,68,115
Callala Bay - Currarong,0,22,0,34,114011273,22,34
Culburra Beach,0,41,0,50,114011274,41,50
Ettrema - Sassafras - Budawang,0,0,0,0,114011275,0,0
Huskisson - Vincentia,0,27,4,59,114011276,27,63
North Nowra - Bomaderry,0,127,0,252,114011277,127,252
Nowra,0,213,0,416,114011278,213,416
St Georges Basin - Erowal Bay,9,117,11,230,114011279,126,241
Sussex Inlet - Berrara,0,0,0,0,114011280,0,0
Tomerong - Wandandian - Woollamia,0,19,0,41,114011281,19,41
Ulladulla,0,119,0,230,114011282,119,230
Ulladulla Region,0,40,0,78,NA,40,78
Bowral,0,51,0,116,114021284,51,116
Hill Top - Colo Vale,0,74,0,107,114021285,74,107
Mittagong,0,96,0,185,114021286,96,185
Moss Vale - Berrima,0,63,0,148,114021287,63,148
Robertson - Fitzroy Falls,0,15,0,43,114021288,15,43
Southern Highlands,0,54,0,76,114021289,54,76
Baulkham Hills (East),0,239,0,470,NA,239,470
Baulkham Hills (West) - Bella Vista,0,178,0,294,115011291,178,294
Glenhaven,0,34,0,60,115011294,34,60
West Pennant Hills,0,96,0,156,115011296,96,156
Castle Hill - Central,0,58,0,119,115011553,58,119
Castle Hill - East,0,22,0,57,115011554,22,57
Castle Hill - North,0,73,0,152,115011555,73,152
Castle Hill - South,0,85,0,144,115011556,85,144
Castle Hill - West,0,47,0,59,115011557,47,59
Cherrybrook,0,107,0,252,115011558,107,252
Kellyville,0,275,0,452,NA,275,452
Dural - Kenthurst - Wisemans Ferry,0,150,0,263,115021297,150,263
Galston - Laughtondale,0,22,0,67,115021298,22,67
Bilpin - Colo - St Albans,0,11,0,21,115031299,11,21
Kurrajong Heights - Ebenezer,0,205,0,331,115031300,205,331
Pitt Town - McGraths Hill,0,132,0,198,115041301,132,198
Rouse Hill - Beaumont Hills,0,497,3,870,115041625,497,873
Blacktown (East) - Kings Park,0,148,0,235,116011303,148,235
Blacktown (North) - Marayong,0,177,0,337,116011304,177,337
Doonside - Woodcroft,0,185,0,309,116011306,185,309
Lalor Park - Kings Langley,0,207,0,403,116011307,207,403
Seven Hills - Toongabbie,0,211,0,400,NA,211,400
Blacktown (South),0,95,0,167,NA,95,167
Blacktown (West),0,160,0,226,NA,160,226
Glenwood,4,130,0,204,116021309,134,204
Parklea - Kellyville Ridge,0,340,0,637,NA,340,637
Riverstone - Marsden Park,0,824,0,1260,NA,824,1260
Acacia Gardens,0,40,0,47,116021562,40,47
Quakers Hill,0,230,0,444,116021563,230,444
Bidwill - Hebersham - Emerton,0,135,0,272,116031313,135,272
Glendenning - Dean Park,0,94,0,125,116031314,94,125
Hassall Grove - Plumpton,0,140,0,260,116031315,140,260
Lethbridge Park - Tregear,0,197,0,388,116031316,197,388
Mount Druitt - Whalan,0,157,0,329,116031317,157,329
Prospect Reservoir,0,0,0,0,116031318,0,0
Rooty Hill - Minchinbury,0,177,0,293,116031319,177,293
Banksmeadow,0,0,0,3,117011320,0,3
Botany,4,119,0,217,117011321,123,217
Mascot - Eastlakes,5,200,3,324,NA,205,327
Pagewood - Hillsdale - Daceyville,0,107,0,172,117011323,107,172
Port Botany Industrial,0,0,0,0,117011324,0,0
Sydney Airport,0,0,0,0,117011325,0,0
Marrickville,0,180,3,319,NA,180,322
Petersham - Stanmore,0,118,5,189,117021327,118,194
Sydenham - Tempe - St Peters,0,64,0,108,117021328,64,108
Darlinghurst,0,27,0,47,117031329,27,47
Erskineville - Alexandria,0,132,0,179,117031330,132,179
Glebe - Forest Lodge,0,113,0,157,117031331,113,157
Newtown - Camperdown - Darlington,0,98,5,155,NA,98,160
Potts Point - Woolloomooloo,0,36,0,52,117031333,36,52
Pyrmont - Ultimo,0,103,0,137,NA,103,137
Redfern - Chippendale,0,88,0,120,NA,88,120
Surry Hills,3,45,0,72,117031336,48,72
Sydney - Haymarket - The Rocks,0,74,0,93,NA,74,93
Waterloo - Beaconsfield,0,259,5,277,NA,259,282
Bondi - Tamarama - Bronte,0,106,0,199,118011339,106,199
Bondi Beach - North Bondi,0,150,4,229,118011340,150,233
Bondi Junction - Waverly,0,103,0,195,118011341,103,195
Centennial Park,0,0,0,0,118011342,0,0
Double Bay - Bellevue Hill,4,122,0,216,NA,126,216
Dover Heights,0,99,0,142,118011344,99,142
Paddington - Moore Park,5,77,0,153,118011345,82,153
Rose Bay - Vaucluse - Watsons Bay,0,68,0,108,118011346,68,108
Woollahra,0,40,0,85,118011347,40,85
Coogee - Clovelly,0,174,0,302,118021651,174,302
Malabar - La Perouse - Chifley,0,174,0,329,NA,174,329
Kensington (NSW),0,63,0,116,118021564,63,116
Kingsford,0,71,0,139,118021565,71,139
Maroubra - North,0,72,0,97,118021566,72,97
Maroubra - South,0,81,0,129,118021567,81,129
Maroubra - West,0,77,0,94,118021568,77,94
Randwick - North,3,116,0,225,118021569,119,225
Randwick - South,0,85,0,121,118021570,85,121
Bass Hill - Georges Hall,0,234,0,363,119011354,234,363
Chullora,0,25,0,26,119011355,25,26
Condell Park,0,136,0,195,119011356,136,195
Greenacre - Mount Lewis,0,247,0,385,NA,247,385
Padstow,0,130,0,213,119011358,130,213
Panania - Milperra - Picnic Point,0,248,0,434,NA,248,434
Revesby,0,152,0,235,119011360,152,235
Yagoona - Birrong,0,198,0,306,119011361,198,306
Bankstown - North,0,133,0,215,119011571,133,215
Bankstown - South,0,133,0,251,119011572,133,251
Belmore - Belfield,0,155,0,224,119021362,155,224
Canterbury (South) - Campsie,0,212,0,325,NA,212,325
Kingsgrove (North) - Earlwood,0,206,0,310,NA,206,310
Punchbowl,0,184,0,330,119021366,184,330
Roselands,0,124,0,214,119021367,124,214
Lakemba,0,121,0,204,119021573,121,204
Wiley Park,0,92,0,158,119021574,92,158
Hurstville,0,132,0,240,NA,132,240
Mortdale - Penshurst,0,184,0,339,NA,184,339
Narwee - Beverly Hills,0,103,0,177,119031370,103,177
Oatley - Hurstville Grove,0,83,0,160,119031371,83,160
Peakhurst - Lugarno,0,160,0,265,119031372,160,265
Riverwood,0,75,0,144,119031373,75,144
South Hurstville - Blakehurst,0,170,0,269,119031374,170,269
Arncliffe - Bardwell Valley,0,208,0,302,119041668,208,302
Bexley,0,219,0,334,NA,219,334
Kingsgrove (South) - Bardwell Park,0,97,0,172,119041377,97,172
Kogarah,0,107,0,143,119041378,107,143
Kogarah Bay - Carlton - Allawah,0,103,0,160,119041379,103,160
Monterey - Brighton-le-Sands - Kyeemagh,0,106,0,165,119041380,106,165
Rockdale - Banksia,0,134,0,248,119041381,134,248
Sans Souci - Ramsgate,0,130,0,208,119041382,130,208
Concord - Mortlake - Cabarita,0,140,0,283,120011383,140,283
Concord West - North Strathfield,0,203,0,334,120011672,203,334
Drummoyne - Rodd Point,0,147,0,240,120011385,147,240
Five Dock - Abbotsford,0,173,0,278,120011386,173,278
Balmain,0,108,0,206,120021387,108,206
Leichhardt - Annandale,0,244,5,412,NA,244,417
Lilyfield - Rozelle,0,133,0,205,120021389,133,205
Ashfield,0,142,0,209,NA,142,209
Burwood - Croydon,0,138,0,232,NA,138,232
Canterbury (North) - Ashbury,0,80,0,121,120031392,80,121
Croydon Park - Enfield,0,121,0,212,120031393,121,212
Dulwich Hill - Lewisham,0,147,0,174,120031394,147,174
Haberfield - Summer Hill,0,85,0,156,120031395,85,156
Homebush,0,178,0,252,120031396,178,252
Strathfield,0,103,0,157,NA,103,157
Strathfield South,0,26,0,52,120031576,26,52
Chatswood (East) - Artarmon,0,223,0,432,NA,223,432
Chatswood (West) - Lane Cove North,0,201,0,304,121011399,201,304
Lane Cove - Greenwich,0,222,0,444,NA,222,444
St Leonards - Naremburn,0,115,0,140,121011401,115,140
Willoughby - Castle Cove - Northbridge,0,214,0,375,NA,214,375
Asquith - Mount Colah,0,205,0,352,121021403,205,352
Berowra - Brooklyn - Cowan,0,100,0,191,121021404,100,191
Normanhurst - Thornleigh - Westleigh,0,177,0,282,121021406,177,282
Hornsby - East,0,95,0,162,121021577,95,162
Hornsby - West,0,95,0,174,121021578,95,174
Waitara - Wahroonga (West),0,107,0,202,NA,107,202
Gordon - Killara,0,138,0,263,121031407,138,263
Lindfield - Roseville,0,176,0,377,121031408,176,377
Pymble,0,135,0,246,121031409,135,246
St Ives,0,166,0,340,121031410,166,340
Turramurra,0,145,0,290,121031411,145,290
Wahroonga (East) - Warrawee,0,111,0,212,121031412,111,212
Cremorne - Cammeray,0,121,0,226,121041413,121,226
Crows Nest - Waverton,0,121,0,206,121041414,121,206
Mosman,0,129,0,306,NA,129,306
Neutral Bay - Kirribilli,0,98,0,157,121041416,98,157
North Sydney - Lavender Bay,0,63,0,101,121041417,63,101
Balgowlah - Clontarf - Seaforth,0,187,0,341,122011418,187,341
Manly - Fairlight,0,143,0,265,122011419,143,265
Avalon - Palm Beach,0,74,0,195,122021420,74,195
Bayview - Elanora Heights,0,71,0,151,122021421,71,151
Newport - Bilgola,0,95,0,176,122021422,95,176
Warriewood - Mona Vale,3,234,3,365,NA,237,368
Beacon Hill - Narraweena,0,129,0,231,122031424,129,231
Cromer,0,69,0,142,122031425,69,142
Dee Why - North Curl Curl,5,213,4,347,NA,218,351
Forestville - Killarney Heights,0,111,0,196,122031427,111,196
Frenchs Forest - Belrose,0,254,0,433,NA,254,433
Freshwater - Brookvale,0,180,0,309,122031429,180,309
Manly Vale - Allambie Heights,0,146,0,318,122031430,146,318
Narrabeen - Collaroy,0,191,0,341,NA,191,341
Terrey Hills - Duffys Forest,0,25,0,51,122031432,25,51
Camden - Ellis Lane,0,106,0,214,123011433,106,214
Elderslie - Harrington Park,0,242,0,464,NA,242,464
Mount Annan - Currans Hill,0,463,0,726,NA,463,726
Bradbury - Wedderburn,0,213,0,356,123021436,213,356
Campbelltown - Woodbine,0,176,0,279,123021437,176,279
Claymore - Eagle Vale - Raby,0,236,0,322,123021438,236,322
Holsworthy Military Area,0,0,0,0,123021439,0,0
Ingleburn - Denham Court,0,363,0,585,NA,363,585
Leumeah - Minto Heights,0,136,0,244,123021441,136,244
Macquarie Fields - Glenfield,0,235,0,361,NA,235,361
Minto - St Andrews,0,174,0,300,123021443,174,300
Rosemeadow - Glen Alpine,0,178,0,254,123021444,178,254
Bargo,0,48,0,88,123031445,48,88
Douglas Park - Appin,0,159,0,241,123031446,159,241
Picton - Tahmoor - Buxton,0,240,0,369,123031447,240,369
The Oaks - Oakdale,0,103,0,154,123031448,103,154
Blackheath - Megalong Valley,0,36,4,73,124011449,36,77
Blaxland - Warrimoo - Lapstone,0,161,0,348,124011450,161,348
Blue Mountains - North,0,0,0,0,124011451,0,0
Katoomba - Leura,0,71,0,127,124011452,71,127
Lawson - Hazelbrook - Linden,0,97,0,156,124011453,97,156
Springwood - Winmalee,0,190,0,330,124011454,190,330
Wentworth Falls,0,41,0,94,124011455,41,94
Blue Mountains - South,0,0,0,0,124021456,0,0
Cambridge Park,0,157,0,265,124031457,157,265
Castlereagh - Cranebrook,0,413,0,624,NA,413,624
Emu Plains - Leonay,0,123,0,242,124031459,123,242
Glenmore Park - Regentville,0,208,0,364,124031460,208,364
Jamisontown - South Penrith,0,133,0,273,124031461,133,273
Kingswood - Werrington,0,224,0,454,124031462,224,454
Mulgoa - Luddenham - Orchard Hills,0,140,0,204,124031463,140,204
Penrith,0,131,0,215,124031464,131,215
Warragamba - Silverdale,0,70,0,118,124031465,70,118
Richmond - Clarendon,0,126,0,224,124041466,126,224
Windsor - Bligh Park,0,139,0,275,124041467,139,275
Yarramundi - Londonderry,0,31,0,90,124041468,31,90
Erskine Park,0,61,0,111,124051469,61,111
St Clair,0,186,0,311,124051470,186,311
Colyton - Oxley Park,0,128,0,192,124051580,128,192
St Marys - North St Marys,0,144,0,258,124051581,144,258
Homebush Bay - Silverwater,0,218,0,336,NA,218,336
Rookwood Cemetery,0,0,0,0,125011475,0,0
Auburn - Central,0,127,0,207,125011582,127,207
Auburn - North,0,64,0,102,125011583,64,102
Auburn - South,0,78,0,99,125011584,78,99
Berala,0,45,0,90,125011585,45,90
Lidcombe,5,122,0,216,125011586,127,216
Regents Park,0,29,0,51,125011587,29,51
Carlingford,0,236,0,481,NA,236,481
Ermington - Rydalmere,0,231,0,374,125021477,231,374
Oatlands - Dundas Valley,0,147,0,272,125021478,147,272
Chester Hill - Sefton,0,161,0,254,125031479,161,254
Fairfield - East,0,102,0,171,125031480,102,171
Granville - Clyde,0,174,0,265,125031481,174,265
Greystanes - Pemulwuy,0,274,0,394,NA,274,394
Guildford - South Granville,0,232,0,291,125031483,232,291
Guildford West - Merrylands West,0,192,0,324,125031484,192,324
Merrylands - Holroyd,0,266,0,421,125031714,266,421
Smithfield Industrial,0,0,0,0,125031486,0,0
Yennora Industrial,0,0,0,0,125031487,0,0
North Parramatta,0,176,5,277,125041489,176,282
North Rocks,0,66,0,142,125041490,66,142
Northmead,0,207,0,316,125041491,207,316
Parramatta - Rosehill,0,224,0,396,NA,224,396
Toongabbie - Constitution Hill,0,183,0,311,125041493,183,311
Winston Hills,0,114,0,198,125041494,114,198
Pendle Hill - Girraween,0,101,0,218,125041588,101,218
Wentworthville - Westmead,0,210,0,287,125041589,210,287
Epping - North Epping,0,229,0,473,NA,229,473
Pennant Hills - Cheltenham,0,154,0,305,126011496,154,305
Eastwood - Denistone,0,178,3,369,NA,178,372
Gladesville - Huntleys Point,0,111,0,214,126021498,111,214
Hunters Hill - Woolwich,0,51,0,120,126021499,51,120
Macquarie Park - Marsfield,0,160,0,268,126021500,160,268
North Ryde - East Ryde,0,131,0,229,126021501,131,229
West Ryde - Meadowbank,0,159,0,269,126021503,159,269
Putney,0,28,0,44,126021590,28,44
Ryde,0,285,0,474,NA,285,474
Ashcroft - Busby - Miller,0,139,0,258,127011504,139,258
Austral - Greendale,0,126,0,189,127011505,126,189
Cobbitty - Leppington,0,733,0,1005,NA,733,1005
Badgerys Creek,0,0,0,0,127011592,0,0
Cecil Hills,0,43,0,69,127011593,43,69
Green Valley,0,85,0,144,127011594,85,144
Hinchinbrook,0,116,0,160,127011595,116,160
Hoxton Park - Carnes Hill - Horningsea Park,0,117,0,214,127011596,117,214
West Hoxton - Middleton Grange,0,184,0,292,127011597,184,292
Bonnyrigg Heights - Bonnyrigg,0,82,0,192,127021509,82,192
Bossley Park - Abbotsbury,0,120,0,186,127021510,120,186
Cabramatta - Lansvale,0,95,0,206,127021511,95,206
Cabramatta West - Mount Pritchard,0,129,0,203,127021512,129,203
Canley Vale - Canley Heights,0,107,0,236,127021513,107,236
Edensor Park,0,74,0,83,127021514,74,83
Fairfield,0,90,0,141,127021515,90,141
Fairfield - West,0,140,0,228,127021516,140,228
Greenfield Park - Prairiewood,0,39,0,86,127021517,39,86
Horsley Park - Kemps Creek,0,23,0,42,127021518,23,42
Smithfield - Wetherill Park,0,136,0,231,127021519,136,231
St Johns Park - Wakeley,0,57,0,139,127021520,57,139
Wetherill Park Industrial,0,0,0,0,127021521,0,0
Casula,0,151,0,239,127031522,151,239
Chipping Norton - Moorebank,0,207,0,342,127031523,207,342
Holsworthy - Wattle Grove,5,213,5,354,127031524,218,359
Liverpool,0,215,0,370,NA,215,370
Lurnea - Cartwright,0,113,0,187,127031599,113,187
Prestons - Edmondson Park,0,244,0,412,NA,244,412
Warwick Farm,0,49,0,66,127031601,49,66
Gymea - Grays Point,0,163,0,289,128011529,163,289
Miranda - Yowie Bay,0,189,0,296,128011530,189,296
Sylvania - Taren Point,0,116,0,215,128011531,116,215
Caringbah,0,125,0,206,128011602,125,206
Caringbah South,0,141,3,233,128011603,141,236
Cronulla - Kurnell - Bundeena,0,183,0,280,128011604,183,280
Lilli Pilli - Port Hacking - Dolans Bay,0,24,0,52,128011605,24,52
Woolaware - Burraneer,0,72,0,136,NA,72,136
Heathcote - Waterfall,0,76,5,98,128021533,76,103
Illawong - Alfords Point,0,88,0,137,128021534,88,137
Menai - Lucas Heights - Woronora,0,220,0,312,128021535,220,312
Oyster Bay - Como - Jannali,0,222,0,404,128021536,222,404
Royal National Park,0,0,0,0,128021537,0,0
Sutherland - Kirrawee,0,238,0,355,128021538,238,355
Engadine,0,178,0,346,128021607,178,346
Loftus - Yarrawarrah,0,70,0,131,128021608,70,131
Woronora Heights,0,18,0,46,128021609,18,46
Migratory - Offshore - Shipping (NSW),0,0,0,0,197979799,0,0
Special purpose codes (NSW),0,0,0,4,NA,0,4
Alfredton,0,188,0,276,201011001,188,276
Ballarat,0,58,0,126,201011002,58,126
Ballarat - North,0,231,3,340,NA,231,343
Ballarat - South,0,231,0,355,NA,231,355
Buninyong,0,45,0,105,201011005,45,105
Delacombe,0,120,0,201,201011006,120,201
Smythes Creek,0,35,0,64,201011007,35,64
Wendouree - Miners Rest,0,142,4,205,201011008,142,209
Bacchus Marsh Region,0,58,0,77,NA,58,77
Creswick - Clunes,0,68,0,100,201021010,68,100
Daylesford,0,43,0,78,201021011,43,78
Gordon (Vic.),0,52,0,70,201021012,52,70
Avoca,0,14,0,34,201031013,14,34
Beaufort,0,22,0,35,201031014,22,35
Golden Plains - North,0,35,0,59,201031015,35,59
Maryborough (Vic.),0,49,0,72,201031016,49,72
Maryborough Region,0,38,0,43,NA,38,43
Bendigo,0,104,0,160,202011018,104,160
California Gully - Eaglehawk,0,109,0,203,202011019,109,203
East Bendigo - Kennington,0,111,0,157,202011020,111,157
Flora Hill - Spring Gully,0,81,0,110,202011021,81,110
Kangaroo Flat - Golden Square,0,184,0,317,202011022,184,317
Maiden Gully,0,70,0,79,202011023,70,79
Strathfieldsaye,3,110,0,197,202011024,113,197
White Hills - Ascot,0,198,0,291,202011025,198,291
Bendigo Region - South,0,83,0,103,NA,83,103
Castlemaine,0,62,0,119,202021027,62,119
Castlemaine Region,0,50,0,99,NA,50,99
Heathcote,0,32,0,35,202021029,32,35
Kyneton,0,83,0,128,202021030,83,128
Woodend,0,74,0,105,202021031,74,105
Bendigo Region - North,0,33,0,60,NA,33,60
Loddon,0,51,0,63,202031033,51,63
Bannockburn,0,104,0,142,203011034,104,142
Golden Plains - South,0,73,0,101,203011035,73,101
Winchelsea,0,57,0,88,203011036,57,88
Belmont,3,140,0,215,203021037,143,215
Corio - Norlane,0,242,0,333,NA,242,333
Geelong,0,108,0,125,203021039,108,125
Geelong West - Hamlyn Heights,4,240,0,345,203021040,244,345
Grovedale,0,408,0,530,NA,408,530
Highton,0,197,0,348,203021042,197,348
Lara,0,218,0,296,203021043,218,296
Leopold,0,137,0,191,203021044,137,191
Newcomb - Moolap,0,113,0,171,203021045,113,171
Newtown (Vic.),0,75,0,160,203021046,75,160
North Geelong - Bell Park,0,121,0,214,203021047,121,214
Clifton Springs,0,159,0,218,203031048,159,218
Lorne - Anglesea,0,35,0,34,203031049,35,34
Ocean Grove - Barwon Heads,3,351,0,465,NA,354,465
Portarlington,0,48,0,74,203031051,48,74
Point Lonsdale - Queenscliff,0,35,0,47,203031052,35,47
Torquay,4,322,0,327,203031053,326,327
Alexandra,0,46,0,76,204011054,46,76
Euroa,0,54,0,63,204011055,54,63
Kilmore - Broadford,0,167,0,218,204011056,167,218
Mansfield (Vic.),0,67,0,121,204011057,67,121
Nagambie,0,32,0,45,204011058,32,45
Seymour,0,41,0,74,204011059,41,74
Seymour Region,0,35,5,50,NA,35,55
Upper Yarra Valley,0,0,0,0,204011061,0,0
Yea,0,33,0,46,204011062,33,46
Benalla,0,80,0,120,204021063,80,120
Benalla Region,0,27,0,30,NA,27,30
Rutherglen,0,42,0,50,204021065,42,50
Wangaratta,0,195,0,266,204021066,195,266
Wangaratta Region,0,76,0,127,NA,76,127
Beechworth,0,35,0,45,204031068,35,45
Bright - Mount Beauty,0,71,0,105,204031069,71,105
Chiltern - Indigo Valley,0,28,0,24,204031070,28,24
Myrtleford,0,38,0,44,204031071,38,44
Towong,0,47,0,64,204031072,47,64
West Wodonga,0,179,0,239,204031073,179,239
Wodonga,3,361,0,459,204031492,364,459
Yackandandah,0,65,0,76,204031075,65,76
Drouin,0,173,0,315,205011076,173,315
Mount Baw Baw Region,0,30,0,75,205011077,30,75
Trafalgar (Vic.),0,82,0,118,205011078,82,118
Warragul,0,170,0,332,205011079,170,332
Alps - East,0,0,0,0,205021080,0,0
Bairnsdale,0,198,0,218,205021081,198,218
Bruthen - Omeo,0,85,0,91,205021082,85,91
Lake King,0,0,0,0,205021083,0,0
Lakes Entrance,0,104,0,139,205021084,104,139
Orbost,0,53,0,79,205021085,53,79
Paynesville,0,51,0,66,205021086,51,66
Foster,0,61,0,110,205031087,61,110
French Island,0,0,0,3,205031088,0,3
Korumburra,0,94,0,151,205031089,94,151
Leongatha,0,116,0,178,205031090,116,178
Phillip Island,0,86,0,128,205031091,86,128
Wilsons Promontory,0,0,0,0,205031092,0,0
Wonthaggi - Inverloch,0,163,0,306,205031093,163,306
Churchill,0,88,0,151,205041094,88,151
Moe - Newborough,0,164,0,198,205041095,164,198
Morwell,0,136,0,172,205041096,136,172
Traralgon,0,279,0,435,NA,279,435
Yallourn North - Glengarry,0,24,0,70,205041098,24,70
Alps - West,0,0,0,0,205051099,0,0
Longford - Loch Sport,0,23,0,44,205051100,23,44
Maffra,0,108,0,177,205051101,108,177
Rosedale,0,15,0,51,205051102,15,51
Sale,4,138,0,194,205051103,142,194
Yarram,0,36,0,55,205051104,36,55
Brunswick,4,179,0,206,NA,183,206
Brunswick East,0,84,0,102,206011106,84,102
Brunswick West,0,104,0,142,206011107,104,142
Coburg,0,260,0,311,NA,260,311
Pascoe Vale South,0,105,0,121,206011109,105,121
Alphington - Fairfield,0,76,0,111,206021110,76,111
Northcote,0,227,0,255,NA,227,255
Thornbury,3,179,0,214,206021112,182,214
Ascot Vale,0,177,0,233,206031113,177,233
Essendon - Aberfeldie,5,182,0,274,NA,187,274
Flemington,0,88,0,91,206031115,88,91
Moonee Ponds,5,113,0,180,206031116,118,180
Carlton,0,48,0,48,206041117,48,48
Docklands,0,69,0,84,206041118,69,84
East Melbourne,0,18,0,22,206041119,18,22
Flemington Racecourse,0,0,0,0,206041120,0,0
Kensington (Vic.),0,108,0,119,206041121,108,119
Melbourne,0,96,0,83,NA,96,83
North Melbourne,0,130,0,133,206041506,130,133
Parkville,0,19,0,29,206041124,19,29
South Yarra - West,0,26,0,49,206041125,26,49
Southbank,0,90,0,95,NA,90,95
West Melbourne,0,0,0,0,NA,0,0
Albert Park,0,92,3,143,206051128,92,146
Elwood,0,118,3,128,206051129,118,131
Port Melbourne,0,141,0,165,206051130,141,165
Port Melbourne Industrial,0,7,0,3,206051511,7,3
South Melbourne,0,91,0,113,206051512,91,113
St Kilda,0,115,0,138,NA,115,138
St Kilda East,0,144,0,163,206051134,144,163
Armadale,0,44,0,87,206061135,44,87
Prahran - Windsor,0,92,0,128,206061136,92,128
South Yarra - East,0,56,0,130,NA,56,130
Toorak,0,38,0,97,206061138,38,97
Abbotsford,4,51,0,47,206071139,55,47
Carlton North - Princes Hill,0,55,0,56,206071140,55,56
Collingwood,0,55,0,57,206071141,55,57
Fitzroy,0,78,0,64,206071142,78,64
Fitzroy North,0,90,0,90,206071143,90,90
Richmond (Vic.),0,201,0,223,NA,201,223
Yarra - North,0,95,3,108,NA,95,111
206319239,0,0,0,0,NA,0,0
Ashburton (Vic.),0,66,0,121,207011146,66,121
Balwyn,0,86,0,139,207011147,86,139
Balwyn North,0,113,0,195,207011148,113,195
Camberwell,0,134,4,247,207011149,134,251
Glen Iris - East,0,115,0,204,207011150,115,204
Hawthorn,0,108,0,210,NA,108,210
Hawthorn East,0,90,0,162,207011152,90,162
Kew,0,132,0,224,NA,132,224
Kew East,0,43,0,80,207011154,43,80
Surrey Hills (West) - Canterbury,0,78,0,142,207011155,78,142
Bulleen,0,73,0,134,207021156,73,134
Doncaster,0,170,0,279,207021157,170,279
Templestowe,0,115,0,193,207021159,115,193
Templestowe Lower,0,99,0,164,207021160,99,164
Doncaster East (North),0,97,0,180,NA,97,180
Doncaster East (South),0,140,0,247,NA,140,247
Blackburn,0,170,0,271,207031161,170,271
Blackburn South,0,88,0,134,207031162,88,134
Box Hill,0,135,0,195,207031163,135,195
Box Hill North,0,148,0,216,207031164,148,216
Burwood,0,76,0,106,NA,76,106
Burwood East,0,81,0,117,207031166,81,117
Surrey Hills (East) - Mont Albert,0,58,0,113,207031167,58,113
Beaumaris,0,86,0,137,208011168,86,137
Brighton (Vic.),0,109,0,213,208011169,109,213
Brighton East,0,138,0,210,208011170,138,210
Cheltenham - Highett (West),0,145,0,197,NA,145,197
Hampton,0,126,0,215,208011172,126,215
Sandringham - Black Rock,0,99,0,163,208011173,99,163
Bentleigh - McKinnon,5,228,0,316,208021174,233,316
Carnegie,0,172,0,223,208021176,172,223
Caulfield - North,0,296,0,295,208021177,296,295
Caulfield - South,0,200,0,225,208021178,200,225
Elsternwick,0,120,0,151,208021179,120,151
Hughesdale,0,59,0,72,208021180,59,72
Murrumbeena,0,89,0,118,208021181,89,118
Ormond - Glen Huntly,0,93,5,149,208021182,93,154
Bentleigh East (North),0,167,0,239,NA,167,239
Bentleigh East (South),0,159,0,212,NA,159,212
Aspendale Gardens - Waterways,0,69,0,109,208031183,69,109
Braeside,0,0,0,0,208031184,0,0
Carrum - Patterson Lakes,0,123,0,143,208031185,123,143
Chelsea - Bonbeach,0,156,0,243,208031186,156,243
Chelsea Heights,0,49,0,83,208031187,49,83
Cheltenham - Highett (East),0,241,4,334,NA,241,338
Edithvale - Aspendale,0,147,0,183,208031189,147,183
Mentone,0,105,0,150,208031190,105,150
Moorabbin - Heatherton,0,108,0,144,208031191,108,144
Moorabbin Airport,0,0,0,0,208031192,0,0
Mordialloc - Parkdale,0,169,0,250,208031193,169,250
Malvern - Glen Iris,0,108,0,206,208041194,108,206
Malvern East,0,144,0,235,208041195,144,235
Bundoora - East,0,99,0,122,209011196,99,122
Greensborough,0,213,0,305,209011197,213,305
Heidelberg - Rosanna,0,126,0,223,209011198,126,223
Heidelberg West,0,133,0,194,209011199,133,194
Ivanhoe,0,94,0,139,209011200,94,139
Ivanhoe East - Eaglemont,0,44,0,78,209011201,44,78
Montmorency - Briar Hill,0,183,0,261,209011202,183,261
Viewbank - Yallambie,0,195,0,274,209011203,195,274
Watsonia,0,96,0,139,209011204,96,139
Kingsbury,0,60,0,72,209021205,60,72
Reservoir - East,0,244,0,303,NA,244,303
Reservoir - West,0,238,0,289,NA,238,289
Preston - East,0,162,0,223,209021428,162,223
Preston - West,0,139,0,166,209021429,139,166
Eltham,0,218,0,370,209031209,218,370
Hurstbridge,0,26,0,45,209031210,26,45
Kinglake,0,45,0,53,209031211,45,53
Panton Hill - St Andrews,0,31,0,55,209031212,31,55
Plenty - Yarrambat,0,72,0,118,209031213,72,118
Research - North Warrandyte,0,50,0,83,209031214,50,83
Wattle Glen - Diamond Creek,0,142,0,204,209031215,142,204
Bundoora - North,0,52,0,82,209041216,52,82
Bundoora - West,0,56,0,73,209041217,56,73
Lalor,0,153,0,342,NA,153,342
Mill Park - North,0,122,0,210,209041220,122,210
Mill Park - South,0,87,0,127,209041221,87,127
Thomastown,0,111,0,258,209041223,111,258
Wallan,0,338,0,458,209041224,338,458
Whittlesea,0,99,0,123,209041225,99,123
Doreen,0,356,0,476,NA,356,476
Epping - East,5,93,0,195,209041431,98,195
Epping - South,0,66,0,83,209041432,66,83
Epping - West,0,135,0,255,NA,135,255
Mernda,0,378,0,445,NA,378,445
South Morang (North),4,134,0,204,NA,138,204
South Morang (South),0,101,0,167,NA,101,167
Wollert,0,370,0,577,209041437,370,577
Airport West,0,87,0,122,210011226,87,122
Essendon Airport,0,0,0,0,210011227,0,0
Keilor,0,53,0,109,210011228,53,109
Keilor East,0,223,0,359,210011534,223,359
Niddrie - Essendon West,0,68,0,98,210011230,68,98
Strathmore,0,69,0,111,210011231,69,111
Gisborne,0,149,0,275,210021232,149,275
Macedon,0,24,0,56,210021233,24,56
Riddells Creek,0,39,0,50,210021234,39,50
Romsey,0,73,0,177,210021235,73,177
Coburg North,0,110,0,118,210031236,110,118
Fawkner,0,109,0,225,210031237,109,225
Pascoe Vale,4,266,0,339,210031538,270,339
Glenroy,0,208,0,354,NA,208,354
Gowanbrae,0,31,0,36,210031439,31,36
Hadfield,0,73,0,105,210031440,73,105
Sunbury,0,110,0,161,210041240,110,161
Sunbury - South,0,346,0,471,210041540,346,471
Broadmeadows,0,100,0,177,210051242,100,177
Campbellfield - Coolaroo,0,117,0,230,210051243,117,230
Gladstone Park - Westmeadows,0,168,0,210,210051245,168,210
Greenvale - Bulla,0,213,0,334,210051246,213,334
Meadow Heights,0,127,0,217,210051247,127,217
Melbourne Airport,0,0,0,0,210051248,0,0
Roxburgh Park - Somerton,0,193,0,278,NA,193,278
Tullamarine,0,75,0,79,210051250,75,79
Craigieburn - Central,0,62,0,113,210051441,62,113
Craigieburn - North,0,131,0,208,210051442,131,208
Craigieburn - South,0,226,0,399,210051443,226,399
Craigieburn - West,0,291,0,505,210051543,291,505
Mickleham - Yuroke,0,384,0,528,210051445,384,528
Bayswater,0,116,0,142,211011251,116,142
Knoxfield - Scoresby,0,150,0,196,211011254,150,196
Lysterfield,0,39,0,77,211011255,39,77
Rowville - Central,0,131,0,200,211011256,131,200
Rowville - North,0,64,0,111,211011257,64,111
Rowville - South,0,90,0,110,211011258,90,110
Wantirna,0,151,0,189,211011259,151,189
Wantirna South,0,136,0,190,211011260,136,190
Boronia,0,191,0,349,211011446,191,349
Ferntree Gully (North),0,129,0,194,NA,129,194
Ferntree Gully (South) - Upper Ferntree Gully,0,141,0,209,211011448,141,209
The Basin,0,26,0,83,211011449,26,83
Donvale - Park Orchards,0,113,0,153,211021261,113,153
Warrandyte - Wonga Park,0,45,0,86,211021262,45,86
Bayswater North,0,116,0,161,211031263,116,161
Croydon Hills - Warranwood,0,151,0,255,211031265,151,255
Ringwood,0,180,0,264,211031266,180,264
Ringwood East,0,201,0,270,211031267,201,270
Ringwood North,0,68,0,131,211031268,68,131
Croydon - East,0,189,0,270,211031450,189,270
Croydon - West,0,131,0,229,211031451,131,229
Croydon South,0,54,0,80,211031452,54,80
Forest Hill,0,98,0,127,211041269,98,127
Mitcham (Vic.),0,182,0,236,211041270,182,236
Nunawading,0,124,0,177,211041271,124,177
Vermont,0,120,0,167,211041272,120,167
Vermont South,0,80,0,131,211041273,80,131
Belgrave - Selby,0,94,0,139,211051274,94,139
Chirnside Park,0,124,0,174,211051275,124,174
Healesville - Yarra Glen,0,87,0,194,211051276,87,194
Kilsyth,0,99,0,141,211051277,99,141
Lilydale - Coldstream,0,148,0,244,211051278,148,244
Monbulk - Silvan,0,40,0,82,211051279,40,82
Montrose,0,86,0,85,211051280,86,85
Mooroolbark,0,239,0,336,211051281,239,336
Mount Dandenong - Olinda,0,58,0,115,211051282,58,115
Mount Evelyn,0,79,0,161,211051283,79,161
Upwey - Tecoma,0,69,0,133,211051284,69,133
Wandin - Seville,0,57,0,111,211051285,57,111
Yarra Valley,0,137,0,213,211051286,137,213
Beaconsfield - Officer,0,301,0,461,212011546,301,461
Bunyip - Garfield,0,69,0,140,212011547,69,140
Emerald - Cockatoo,0,139,0,273,212011289,139,273
Koo Wee Rup,0,121,0,171,212011548,121,171
Pakenham - North,0,320,0,485,NA,320,485
Pakenham - South,0,360,0,655,NA,360,655
Berwick - North,0,171,0,288,212021293,171,288
Berwick - South,0,334,0,512,NA,334,512
Doveton,0,88,0,173,212021295,88,173
Hallam,0,106,0,177,212021297,106,177
Narre Warren North,0,47,0,86,212021299,47,86
Endeavour Hills - North,0,101,0,136,212021453,101,136
Endeavour Hills - South,0,103,0,182,212021454,103,182
Narre Warren - North East,0,116,0,198,212021455,116,198
Narre Warren - South West,0,136,0,226,212021456,136,226
Cranbourne,0,206,0,335,212031300,206,335
Cranbourne East,0,1040,0,1395,NA,1040,1395
Cranbourne North,0,292,0,524,NA,292,524
Cranbourne South,0,253,0,343,212031303,253,343
Cranbourne West,0,323,0,470,212031304,323,470
Hampton Park - Lynbrook,0,170,0,383,NA,170,383
Lynbrook - Lyndhurst,0,200,0,262,212031306,200,262
Pearcedale - Tooradin,0,75,0,119,212031308,75,119
Narre Warren South (East),0,104,0,142,NA,104,142
Narre Warren South (West),0,129,0,259,NA,129,259
Clarinda - Oakleigh South,0,92,0,138,212041309,92,138
Clayton South,0,88,0,146,212041310,88,146
Dandenong,0,175,0,428,NA,175,428
Dandenong North,0,152,0,273,212041312,152,273
Dingley Village,0,77,0,136,212041313,77,136
Keysborough,0,300,0,459,NA,300,459
Noble Park North,0,48,0,68,212041316,48,68
Springvale,0,125,0,204,212041317,125,204
Springvale South,0,61,0,128,212041318,61,128
Noble Park - East,0,91,0,154,212041459,91,154
Noble Park - West,0,118,0,204,212041460,118,204
Ashwood - Chadstone,0,187,0,250,212051319,187,250
Clayton,0,114,0,140,NA,114,140
Glen Waverley - East,0,123,0,246,212051321,123,246
Glen Waverley - West,0,141,0,229,212051322,141,229
Mount Waverley - North,0,103,0,165,212051323,103,165
Mount Waverley - South,0,166,0,229,212051324,166,229
Mulgrave,0,158,0,264,212051325,158,264
Oakleigh - Huntingdale,0,182,0,271,212051326,182,271
Wheelers Hill,0,103,0,206,212051327,103,206
Ardeer - Albion,0,63,0,80,213011328,63,80
Cairnlea,0,64,0,118,213011329,64,118
Deer Park - Derrimut,0,272,0,327,NA,272,327
Delahey,0,45,0,46,213011331,45,46
Keilor Downs,0,98,0,159,213011332,98,159
Kings Park (Vic.),0,86,0,168,213011333,86,168
St Albans - North,0,156,0,249,213011334,156,249
St Albans - South,0,103,0,177,213011335,103,177
Sunshine,0,84,0,89,213011336,84,89
Sunshine North,0,92,0,128,213011337,92,128
Sunshine West,0,126,0,238,213011338,126,238
Sydenham,0,93,0,103,213011339,93,103
Taylors Lakes,0,109,0,121,213011340,109,121
Altona,0,133,0,174,213021341,133,174
Altona Meadows,0,149,0,232,213021342,149,232
Altona North,3,155,0,160,213021343,158,160
Newport,0,266,0,321,213021344,266,321
Seabrook,0,42,0,94,213021345,42,94
Williamstown,0,80,0,151,213021346,80,151
Braybrook,0,164,0,230,213031347,164,230
Footscray,0,128,5,111,213031348,128,116
Maribyrnong,0,90,0,131,213031349,90,131
Seddon - Kingsville,0,121,0,124,213031350,121,124
West Footscray - Tottenham,0,124,0,167,213031351,124,167
Yarraville,0,176,0,190,213031352,176,190
Bacchus Marsh,0,261,0,387,213041353,261,387
Hillside,0,248,0,402,213041575,248,402
Melton,0,168,0,321,213041577,168,321
Melton South,0,466,0,733,NA,466,733
Melton West,0,240,0,461,213041358,240,461
Rockbank - Mount Cottrell,0,235,0,231,213041359,235,231
Taylors Hill,0,163,0,273,213041360,163,273
Burnside,0,47,0,46,213041461,47,46
Burnside Heights,0,59,0,143,213041462,59,143
Caroline Springs,0,170,0,281,213041463,170,281
Hoppers Crossing - North,0,151,0,197,213051361,151,197
Hoppers Crossing - South,0,139,0,239,213051362,139,239
Laverton,0,138,0,183,213051363,138,183
Tarneit,0,815,0,1088,NA,815,1088
Truganina,4,587,0,896,NA,591,896
Werribee - South,0,155,0,232,213051368,155,232
Wyndham Vale,0,503,0,641,NA,503,641
Point Cook - East,0,269,0,398,213051464,269,398
Point Cook - North,4,260,0,385,NA,264,385
Point Cook - South,0,327,0,510,213051466,327,510
Werribee - East,0,144,0,229,213051467,144,229
Werribee - West,0,288,0,414,213051468,288,414
Carrum Downs,0,230,0,336,214011370,230,336
Frankston,0,219,0,320,214011371,219,320
Frankston North,0,184,0,271,214011372,184,271
Frankston South,0,164,0,256,214011373,164,256
Langwarrin,0,279,0,382,214011374,279,382
Seaford (Vic.),0,226,0,258,214011375,226,258
Skye - Sandhurst,0,142,0,228,214011376,142,228
Dromana,0,74,0,132,214021377,74,132
Flinders,0,27,0,47,214021378,27,47
Hastings - Somers,0,201,0,332,214021379,201,332
Mornington,0,190,0,266,NA,190,266
Mount Eliza,0,122,0,267,214021381,122,267
Mount Martha,0,135,0,266,214021382,135,266
Point Nepean,0,142,3,187,214021383,142,190
Rosebud - McCrae,0,166,0,261,214021384,166,261
Somerville,0,157,0,228,214021385,157,228
Ararat,0,88,0,92,215011386,88,92
Ararat Region,0,25,0,41,NA,25,41
Horsham,0,155,0,245,215011388,155,245
Horsham Region,0,22,0,31,NA,22,31
Nhill Region,0,42,0,44,215011390,42,44
St Arnaud,0,17,0,23,215011391,17,23
Stawell,0,47,0,74,215011392,47,74
West Wimmera,0,20,7,34,215011393,20,41
Yarriambiack,0,42,0,56,215011394,42,56
Irymple,0,62,0,125,215021395,62,125
Merbein,0,41,0,64,215021396,41,64
Mildura Region,0,32,0,44,NA,32,44
Red Cliffs,0,52,0,84,215021399,52,84
Mildura - North,0,164,0,283,215021469,164,283
Mildura - South,0,143,0,265,215021470,143,265
Buloke,0,43,0,40,215031400,43,40
Gannawarra,0,34,0,71,215031401,34,71
Kerang,0,30,0,43,215031402,30,43
Robinvale,0,20,0,56,215031403,20,56
Swan Hill,0,106,0,192,215031404,106,192
Swan Hill Region,0,42,0,84,NA,42,84
Echuca,0,162,0,205,216011406,162,205
Kyabram,0,109,0,160,216011407,109,160
Lockington - Gunbower,0,33,0,46,216011408,33,46
Rochester,0,25,0,57,216011409,25,57
Rushworth,0,28,0,42,216011410,28,42
Cobram,0,76,0,89,216021411,76,89
Moira,0,20,0,32,216021412,20,32
Numurkah,0,118,0,131,216021413,118,131
Yarrawonga,0,79,0,104,216021414,79,104
Mooroopna,0,87,0,97,216031415,87,97
Shepparton - North,0,186,0,275,216031416,186,275
Shepparton - South,0,252,0,383,NA,252,383
Shepparton Region - East,0,34,0,46,NA,34,46
Shepparton Region - West,0,88,0,111,NA,88,111
Glenelg (Vic.),0,65,0,82,217011420,65,82
Hamilton (Vic.),0,105,0,116,217011421,105,116
Portland,0,90,0,117,217011422,90,117
Southern Grampians,0,55,0,70,217011423,55,70
Camperdown,0,30,0,39,217031471,30,39
Colac,0,123,0,160,217031472,123,160
Colac Region,0,57,0,94,NA,57,94
Corangamite - North,0,61,0,59,217031474,61,59
Corangamite - South,0,64,0,111,217031475,64,111
Otway,0,37,0,41,217031476,37,41
Moyne - East,0,56,0,112,217041477,56,112
Moyne - West,5,102,0,100,217041478,107,100
Warrnambool - North,0,234,0,330,217041479,234,330
Warrnambool - South,0,119,0,175,217041480,119,175
Migratory - Offshore - Shipping (Vic.),0,0,0,0,297979799,0,0
Special purpose codes (Vic.),0,0,0,7,NA,0,7
Alexandra Hills,202,0,210,3,301011001,202,213
Belmont - Gumdale,66,0,80,0,301011002,66,80
Birkdale,165,0,155,8,301011003,165,163
Capalaba,230,0,191,0,301011004,230,191
Thorneside,47,0,35,0,301011005,47,35
Wellington Point,125,0,111,0,301011006,125,111
Cleveland,120,0,87,0,301021007,120,87
Ormiston,36,0,59,5,301021008,36,64
Redland Bay,258,0,196,0,301021009,258,196
Sheldon - Mount Cotton,133,0,126,0,301021011,133,126
Thornlands,251,0,228,3,301021012,251,231
Victoria Point,160,0,138,0,301021013,160,138
Redland Islands,44,0,49,3,NA,44,52
Brisbane Port - Lytton,0,0,0,0,301031014,0,0
Manly - Lota,71,0,83,0,301031015,71,83
Manly West,155,0,147,4,301031016,155,151
Murarrie,70,0,52,0,301031017,70,52
Tingalpa,112,0,117,0,301031018,112,117
Wakerley,145,0,158,6,301031019,145,164
Wynnum,148,0,157,3,301031020,148,160
Wynnum West - Hemmant,167,3,162,7,301031021,170,169
Bald Hills,102,0,98,0,302011022,102,98
Bridgeman Downs,111,0,131,0,302011023,111,131
Carseldine,84,0,114,3,302011024,84,117
Everton Park,129,0,122,0,302011025,129,122
McDowall,102,0,88,0,302011026,102,88
Aspley,122,0,134,3,302021027,122,137
Chermside,91,0,101,0,302021028,91,101
Chermside West,76,0,67,0,302021029,76,67
Geebung,55,0,52,0,302021030,55,52
Kedron - Gordon Park,153,0,163,4,302021031,153,167
Stafford,78,0,75,0,302021032,78,75
Stafford Heights,106,0,75,0,302021033,106,75
Wavell Heights,146,0,136,0,302021034,146,136
Boondall,95,0,96,0,302031035,95,96
Brisbane Airport,5,0,4,0,302031036,5,4
Eagle Farm - Pinkenba,16,0,9,0,302031037,16,9
Northgate - Virginia,98,0,87,0,302031038,98,87
Nudgee - Banyo,147,0,132,4,302031039,147,136
Nundah,92,0,100,3,302031040,92,103
Bracken Ridge,232,4,212,5,302041041,236,217
Brighton (Qld),115,3,99,4,302041042,118,103
Deagon,37,0,34,0,302041043,37,34
Sandgate - Shorncliffe,63,0,60,3,302041044,63,63
Taigum - Fitzgibbon,191,0,175,0,302041045,191,175
Zillmere,82,0,102,0,302041046,82,102
Camp Hill,171,0,158,3,303011047,171,161
Cannon Hill,73,0,82,4,303011048,73,86
Carina,134,0,148,0,303011049,134,148
Carina Heights,72,0,66,0,303011050,72,66
Carindale,148,0,165,3,303011051,148,168
Annerley,105,0,110,6,303021052,105,116
Coorparoo,143,0,174,0,303021053,143,174
Fairfield - Dutton Park,38,0,40,5,303021054,38,45
Greenslopes,85,0,77,0,303021055,85,77
Holland Park,106,0,112,0,303021056,106,112
Holland Park West,78,0,83,0,303021057,78,83
Woolloongabba,53,0,39,0,303021058,53,39
Yeronga,100,5,93,0,303021059,105,93
Eight Mile Plains,172,0,174,3,303031060,172,177
Macgregor (Qld),45,0,39,0,303031061,45,39
Mansfield (Qld),63,0,92,0,303031062,63,92
Mount Gravatt,168,0,173,3,303031063,168,176
Rochedale - Burbank,152,0,156,0,303031064,152,156
Upper Mount Gravatt,97,0,116,0,303031065,97,116
Wishart,101,0,116,0,303031066,101,116
Coopers Plains,47,0,55,3,303041067,47,58
Moorooka,121,0,129,0,303041068,121,129
Robertson,41,0,46,0,303041069,41,46
Salisbury - Nathan,95,0,102,5,303041070,95,107
Tarragindi,153,0,159,3,303041071,153,162
Algester,119,3,122,0,303051072,122,122
Calamvale - Stretton,262,0,315,3,303051073,262,318
Pallara - Willawong,158,7,153,3,303051074,165,156
Parkinson - Drewvale,172,0,218,6,303051075,172,224
Rocklea - Acacia Ridge,79,0,119,0,303051076,79,119
Kuraby,81,0,89,3,303061077,81,92
Runcorn,121,0,191,3,303061078,121,194
Sunnybank,63,0,75,0,303061079,63,75
Sunnybank Hills,193,0,186,3,303061080,193,189
Jindalee - Mount Ommaney,74,0,84,0,304011081,74,84
Middle Park - Jamboree Heights,84,3,86,0,304011082,87,86
Riverhills,54,0,56,0,304011083,54,56
Seventeen Mile Rocks - Sinnamon Park,87,0,114,5,304011084,87,119
Westlake,46,0,50,3,304011085,46,53
Bellbowrie - Moggill,93,3,140,0,304021086,96,140
Brookfield - Kenmore Hills,56,0,58,5,304021087,56,63
Chapel Hill,116,0,110,3,304021088,116,113
Fig Tree Pocket,41,4,49,0,304021089,45,49
Kenmore,115,0,116,3,304021090,115,119
Pinjarra Hills - Pullenvale,30,0,44,0,304021091,30,44
Chelmer - Graceville,94,0,77,4,304031092,94,81
Corinda,52,0,63,0,304031093,52,63
Indooroopilly,122,0,113,0,304031094,122,113
Sherwood,57,0,57,0,304031095,57,57
St Lucia,77,0,70,0,304031096,77,70
Taringa,73,0,79,5,304031097,73,84
Enoggera,109,0,102,0,304041098,109,102
Enoggera Reservoir,0,0,0,0,304041099,0,0
Keperra,72,0,82,3,304041100,72,85
Mitchelton,114,0,144,3,304041101,114,147
Mount Coot-tha,0,0,0,0,304041102,0,0
The Gap,178,0,176,0,304041103,178,176
Upper Kedron - Ferny Grove,161,0,142,3,304041104,161,145
Brisbane City,37,0,42,0,305011105,37,42
Fortitude Valley,35,0,18,0,305011106,35,18
Highgate Hill,28,0,21,0,305011107,28,21
Kangaroo Point,40,0,39,0,305011108,40,39
New Farm,76,0,68,0,305011109,76,68
South Brisbane,43,0,51,0,305011110,43,51
Spring Hill,22,0,16,0,305011111,22,16
West End,75,0,94,0,305011112,75,94
Balmoral,56,0,50,0,305021113,56,50
Bulimba,69,0,76,0,305021114,69,76
East Brisbane,37,0,35,0,305021115,37,35
Hawthorne,47,0,55,3,305021116,47,58
Morningside - Seven Hills,161,0,189,0,305021117,161,189
Norman Park,72,0,88,0,305021118,72,88
Albion,22,0,24,0,305031119,22,24
Alderley,68,0,78,3,305031120,68,81
Ascot,52,0,59,0,305031121,52,59
Clayfield,74,0,117,0,305031122,74,117
Grange,66,0,67,3,305031123,66,70
Hamilton (Qld),36,0,43,0,305031124,36,43
Hendra,52,4,78,0,305031125,56,78
Kelvin Grove - Herston,63,0,57,0,305031126,63,57
Newmarket,48,0,37,0,305031127,48,37
Newstead - Bowen Hills,71,0,76,0,305031128,71,76
Wilston,36,0,42,0,305031129,36,42
Windsor,84,0,76,5,305031130,84,81
Wooloowin - Lutwyche,92,0,102,0,305031131,92,102
Ashgrove,135,0,165,0,305041132,135,165
Auchenflower,26,0,35,0,305041133,26,35
Bardon,133,0,132,7,305041134,133,139
Paddington - Milton,108,0,109,0,305041135,108,109
Red Hill (Qld),48,0,43,4,305041136,48,47
Toowong,100,0,78,0,305041137,100,78
Brinsmead,60,0,70,0,306011138,60,70
Clifton Beach - Kewarra Beach,106,0,96,0,306011139,106,96
Freshwater - Stratford,32,0,41,0,306011140,32,41
Redlynch,141,0,159,0,306011141,141,159
Trinity Beach - Smithfield,199,0,192,3,306011142,199,195
Yorkeys Knob - Machans Beach,39,0,49,0,306011143,39,49
Bentley Park,148,0,123,0,306021144,148,123
Cairns City,57,0,47,4,306021145,57,51
Earlville - Bayview Heights,76,5,71,0,306021146,81,71
Edmonton,169,0,152,0,306021147,169,152
Gordonvale - Trinity,111,0,98,0,306021148,111,98
Kanimbla - Mooroobool,108,0,95,3,306021149,108,98
Lamb Range,0,0,0,0,306021150,0,0
Manoora,50,0,67,4,306021151,50,71
Manunda,55,0,48,5,306021152,55,53
Mount Sheridan,113,0,115,0,306021153,113,115
Westcourt - Bungalow,35,0,38,4,306021154,35,42
White Rock,61,0,69,0,306021155,61,69
Whitfield - Edge Hill,53,0,73,3,306021156,53,76
Woree,44,0,49,6,306021157,44,55
Babinda,28,0,47,0,306031158,28,47
Innisfail,62,0,91,0,306031159,62,91
Johnstone,51,0,77,0,306031160,51,77
Tully,69,0,117,0,306031161,69,117
Wooroonooran,0,0,0,0,306031162,0,0
Yarrabah,16,0,58,0,306031163,16,58
Daintree,46,0,58,0,306041164,46,58
Port Douglas,54,0,40,0,306041165,54,40
Atherton,83,0,105,3,306051166,83,108
Herberton,29,0,36,5,306051167,29,41
Kuranda,30,0,38,0,306051168,30,38
Malanda - Yungaburra,50,0,48,6,306051169,50,54
Mareeba,87,7,114,11,306051170,94,125
Balonne,49,0,41,7,307011171,49,48
Chinchilla,44,6,104,11,307011172,50,115
Goondiwindi,81,0,87,3,307011173,81,90
Inglewood - Waggamba,37,3,42,4,307011174,40,46
Miles - Wandoan,35,3,44,0,307011175,38,44
Roma,89,0,72,3,307011176,89,75
Roma Region,53,0,52,0,NA,53,52
Tara,21,0,38,0,307011178,21,38
Crows Nest - Rosalie,61,5,81,7,307021179,66,88
Jondaryan,64,7,64,3,307021180,71,67
Millmerran,30,0,18,0,307021181,30,18
Pittsworth,48,0,62,3,307021182,48,65
Wambo,172,3,185,3,307021183,175,188
Clifton - Greenmount,43,0,39,0,307031184,43,39
Southern Downs - East,21,0,35,0,307031185,21,35
Southern Downs - West,32,5,33,0,307031186,37,33
Stanthorpe,35,0,44,0,307031187,35,44
Stanthorpe Region,26,0,46,0,NA,26,46
Warwick,118,0,156,4,307031189,118,160
Central Highlands - East,32,0,116,5,308011190,32,121
Central Highlands - West,50,0,81,7,308011191,50,88
Emerald,156,5,199,10,308011192,161,209
Berserker,69,0,75,0,308031205,69,75
Bouldercombe,19,0,16,0,308031206,19,16
Emu Park,102,0,61,5,308031207,102,66
Frenchville - Mount Archer,96,4,115,3,308031208,100,118
Glenlee - Rockyview,47,0,55,5,308031209,47,60
Gracemere,228,0,185,12,308031210,228,197
Lakes Creek,44,3,50,4,308031211,47,54
Mount Morgan,18,0,14,0,308031212,18,14
Norman Gardens,115,0,114,5,308031213,115,119
Park Avenue,55,0,64,0,308031214,55,64
Parkhurst - Kawana,91,0,110,7,308031215,91,117
Rockhampton - West,59,0,58,0,308031216,59,58
Rockhampton City,31,0,24,0,308031217,31,24
Rockhampton Region - East,32,0,35,0,NA,32,35
Rockhampton Region - North,0,0,0,0,NA,0,0
Rockhampton Region - West,27,0,34,0,NA,27,34
Shoalwater Bay,0,0,0,0,308031221,0,0
The Range - Allenstown,61,0,63,0,308031222,61,63
Yeppoon,194,0,258,3,308031223,194,261
Banana,38,0,95,8,308041528,38,103
Biloela,23,0,75,0,308041529,23,75
Agnes Water - Miriam Vale,32,0,46,3,308051530,32,49
Boyne Island - Tannum Sands,122,3,121,7,308051531,125,128
Callemondah,0,0,0,0,308051532,0,0
Clinton - New Auckland,159,5,207,8,308051533,164,215
Gladstone,57,0,52,4,308051534,57,56
Gladstone Hinterland,106,0,158,3,308051535,106,161
Kin Kora - Sun Valley,49,0,47,5,308051536,49,52
South Trees,0,0,0,0,308051537,0,0
Telina - Toolooa,77,0,88,3,308051538,77,91
West Gladstone,42,0,49,0,308051539,42,49
Broadbeach Waters,77,0,79,0,309011224,77,79
Burleigh Heads,71,0,58,0,309011225,71,58
Burleigh Waters,152,0,176,0,309011226,152,176
Mermaid Beach - Broadbeach,76,0,73,0,309011227,76,73
Mermaid Waters,144,0,160,0,309011228,144,160
Miami,90,0,70,3,309011229,90,73
Coolangatta,45,0,31,0,309021230,45,31
Currumbin - Tugun,125,0,111,3,309021231,125,114
Currumbin Waters,127,3,114,0,309021232,130,114
Elanora,166,3,140,0,309021233,169,140
Palm Beach,172,0,152,0,309021234,172,152
Arundel,120,0,121,0,309031235,120,121
Biggera Waters,88,0,61,0,309031236,88,61
Coombabah,82,0,81,0,309031237,82,81
Labrador,169,0,126,0,309031238,169,126
Paradise Point - Hollywell,90,0,62,5,309031239,90,67
Runaway Bay,60,0,60,0,309031240,60,60
Guanaba - Springbrook,41,3,43,0,309041241,44,43
Tamborine - Canungra,139,0,144,0,309041242,139,144
Currumbin Valley - Tallebudgera,85,0,85,0,309051243,85,85
Mudgeeraba - Bonogin,287,3,220,0,309051244,290,220
Reedy Creek - Andrews,101,0,118,4,309051245,101,122
Carrara,154,0,143,0,309061246,154,143
Highland Park,134,0,89,0,309061247,134,89
Nerang - Mount Nathan,272,4,224,6,309061248,276,230
Pacific Pines - Gaven,241,0,248,7,309061249,241,255
Worongary - Tallai,90,0,84,4,309061250,90,88
Coomera,350,11,311,9,309071251,361,320
Helensvale,210,0,206,0,309071252,210,206
Hope Island,122,0,108,5,309071253,122,113
Jacobs Well - Alberton,50,0,42,0,309071254,50,42
Ormeau - Yatala,391,0,336,9,NA,391,345
Oxenford - Maudsland,268,3,227,7,309071256,271,234
Pimpama,493,8,393,12,NA,501,405
Upper Coomera - Willow Vale,565,20,513,3,NA,585,516
Clear Island Waters,30,0,31,0,309081259,30,31
Merrimac,95,0,65,0,309081260,95,65
Robina,254,0,229,3,NA,254,232
Varsity Lakes,224,0,173,0,309081262,224,173
Ashmore,121,0,130,0,309091263,121,130
Molendinar,81,0,65,0,309091264,81,65
Parkwood,88,0,77,0,309091265,88,77
Southport - North,125,0,95,0,309091540,125,95
Southport - South,145,0,126,0,309091541,145,126
Benowa,76,0,91,0,309101267,76,91
Bundall,65,0,46,0,309101268,65,46
Main Beach,13,0,16,0,309101269,13,16
Surfers Paradise,110,0,129,0,NA,110,129
Darra - Sumner,50,0,56,4,310011271,50,60
Durack,65,0,80,0,310011272,65,80
Forest Lake - Doolandella,315,0,362,3,NA,315,365
Inala - Richlands,182,0,254,13,310011274,182,267
Oxley (Qld),103,0,129,7,310011275,103,136
Wacol,20,0,28,0,310011276,20,28
Boonah,84,0,97,3,310021277,84,100
Esk,37,0,39,0,310021278,37,39
Lake Manchester - England Creek,0,0,0,0,310021279,0,0
Lockyer Valley - East,247,0,213,3,310021280,247,216
Lowood,162,0,164,10,310021281,162,174
Rosewood,117,0,123,6,310021282,117,129
Brassall,138,0,152,0,310031283,138,152
Bundamba,89,0,78,3,310031284,89,81
Churchill - Yamanto,119,0,79,0,310031285,119,79
Ipswich - Central,63,0,51,0,310031286,63,51
Ipswich - East,149,0,160,4,310031287,149,164
Ipswich - North,51,0,40,0,310031288,51,40
Karalee - Barellan Point,81,0,83,0,310031289,81,83
Karana Downs,48,0,50,0,310031290,48,50
Leichhardt - One Mile,103,0,109,5,310031291,103,114
North Ipswich - Tivoli,74,0,60,0,310031292,74,60
Raceview,203,0,176,5,310031293,203,181
Ripley,199,0,184,3,310031294,199,187
Riverview,24,0,28,0,310031295,24,28
Bellbird Park - Brookwater,258,0,297,6,NA,258,303
Camira - Gailes,85,3,97,0,310041297,88,97
Carole Park,0,0,0,0,310041298,0,0
Collingwood Park - Redbank,133,5,161,7,310041299,138,168
Goodna,106,0,123,6,310041300,106,129
New Chum,0,0,0,0,310041301,0,0
Redbank Plains,321,0,374,12,310041302,321,386
Springfield,110,3,112,3,310041303,113,115
Springfield Lakes,444,12,382,26,310041304,456,408
Beaudesert,102,3,132,6,311011305,105,138
Beenleigh,101,0,75,0,311021306,101,75
Eagleby,154,0,175,6,311021307,154,181
Edens Landing - Holmview,162,4,135,3,311021308,166,138
Mount Warren Park,55,4,59,0,311021309,59,59
Wolffdene - Bahrs Scrub,121,0,106,0,311021310,121,106
Boronia Heights - Park Ridge,239,0,207,3,311031311,239,210
Browns Plains,89,0,86,0,311031312,89,86
Chambers Flat - Logan Reserve,127,0,107,4,311031313,127,111
Crestmead,161,0,162,0,311031314,161,162
Greenbank Military Camp,0,0,0,0,311031315,0,0
Hillcrest,102,0,84,4,311031316,102,88
Marsden,190,0,214,13,311031317,190,227
Munruben - Park Ridge South,34,0,37,0,311031318,34,37
Regents Park - Heritage Park,219,0,195,7,311031319,219,202
Greenbank,210,3,236,0,NA,213,236
Jimboomba,486,0,524,20,NA,486,544
Logan Village,103,0,67,3,311041322,103,70
Bethania - Waterford,172,0,131,3,311051323,172,134
Cornubia - Carbrook,111,0,77,0,311051324,111,77
Loganholme - Tanah Merah,156,0,145,3,311051325,156,148
Loganlea,134,0,132,0,311051326,134,132
Shailer Park,148,0,113,0,311051327,148,113
Waterford West,74,0,90,0,311051328,74,90
Daisy Hill,73,0,62,0,311061329,73,62
Kingston (Qld.),111,0,125,3,NA,111,128
Logan Central,66,0,71,5,311061331,66,76
Rochedale South - Priestdale,192,3,168,0,311061332,195,168
Slacks Creek,100,0,100,4,311061333,100,104
Springwood,98,0,84,4,311061334,98,88
Underwood,81,0,87,4,311061335,81,91
Woodridge,113,0,145,5,311061336,113,150
Bowen,86,3,63,34,312011337,89,97
Broadsound - Nebo,64,0,101,5,312011338,64,106
Clermont,36,0,55,0,312011339,36,55
Collinsville,0,0,0,0,312011340,0,0
Moranbah,85,3,134,12,312011341,88,146
Andergrove - Beaconsfield,162,0,175,11,312021342,162,186
East Mackay,23,0,32,0,312021343,23,32
Eimeo - Rural View,163,0,191,9,312021344,163,200
Eungella Hinterland,0,0,0,0,312021345,0,0
Mackay,16,0,23,0,312021346,16,23
Mackay Harbour,5,0,3,0,312021347,5,3
Mount Pleasant - Glenella,102,0,111,0,312021348,102,111
North Mackay,47,0,60,0,312021349,47,60
Ooralea - Bakers Creek,61,0,95,0,312021350,61,95
Pioneer Valley,117,3,179,9,312021351,120,188
Sarina,107,7,123,13,312021352,114,136
Seaforth - Calen,0,0,0,0,312021353,0,0
Shoal Point - Bucasia,50,0,81,0,312021354,50,81
Slade Point,27,0,45,4,312021355,27,49
South Mackay,45,0,77,0,312021356,45,77
Walkerston - Eton,97,0,105,0,312021357,97,105
West Mackay,55,0,61,5,312021358,55,66
Airlie - Whitsundays,111,0,135,3,312031359,111,138
Cape Conway,0,0,0,0,312031360,0,0
Proserpine,66,0,89,3,312031361,66,92
Beachmere - Sandstone Point,134,0,141,0,313011362,134,141
Bribie Island,72,0,97,0,313011363,72,97
Burpengary - East,93,0,80,4,313021364,93,84
Caboolture,398,0,336,10,NA,398,346
Caboolture - South,288,0,275,5,313021366,288,280
Elimbah,49,0,35,0,313021367,49,35
Morayfield - East,150,0,140,7,313021368,150,147
Wamuran,29,0,42,0,313021369,29,42
Kilcoy,38,0,36,0,313031370,38,36
Woodford - D'Aguilar,70,0,75,0,313031371,70,75
Burpengary,184,5,183,8,313041372,189,191
Deception Bay,217,0,229,9,313041373,217,238
Morayfield,66,0,56,0,313041374,66,56
Narangba,270,5,277,3,313041375,275,280
Upper Caboolture,23,0,34,0,313041376,23,34
Clontarf,75,0,80,0,313051377,75,80
Margate - Woody Point,111,0,88,0,313051378,111,88
Redcliffe,61,0,67,0,313051379,61,67
Rothwell - Kippa-Ring,162,0,158,8,313051380,162,166
Scarborough - Newport - Moreton Island,140,5,103,0,NA,145,103
Albany Creek,168,0,163,0,314011382,168,163
Cashmere,245,0,301,6,314011383,245,307
Dayboro,89,0,92,3,314011384,89,95
Eatons Hill,87,0,88,5,314011385,87,93
The Hills District,310,0,296,8,314011386,310,304
Samford Valley,110,0,119,7,314011387,110,126
Dakabin - Kallangur,317,0,329,10,NA,317,339
Murrumba Downs - Griffin,348,0,376,11,314021389,348,387
North Lakes - Mango Hill,540,0,566,9,NA,540,575
Bray Park,119,0,110,0,314031391,119,110
Lawnton,101,0,96,0,314031392,101,96
Petrie,94,0,98,0,314031393,94,98
Strathpine - Brendale,147,4,142,5,314031394,151,147
Aurukun,0,0,0,0,315011395,0,0
Cape York,29,3,104,11,315011396,32,115
Croydon - Etheridge,15,0,8,0,315011397,15,8
Kowanyama - Pormpuraaw,0,0,38,0,315011398,0,38
Northern Peninsula,21,0,74,0,315011399,21,74
Tablelands,24,0,31,7,315011400,24,38
Torres,15,0,50,0,315011401,15,50
Torres Strait Islands,15,0,83,0,315011402,15,83
Weipa,46,0,65,3,315011403,46,68
Carpentaria,7,0,61,0,315021404,7,61
Mount Isa,156,0,247,10,315021405,156,257
Mount Isa Region,26,3,60,0,NA,29,60
Northern Highlands,26,0,46,5,315021407,26,51
Barcaldine - Blackall,47,0,45,0,315031408,47,45
Charleville,22,0,42,3,315031409,22,45
Far Central West,15,0,15,5,315031410,15,20
Far South West,10,0,19,0,315031411,10,19
Longreach,28,0,32,4,315031412,28,36
Buderim - North,151,3,186,0,316011413,154,186
Buderim - South,159,0,161,0,316011414,159,161
Mountain Creek,151,0,137,0,316011415,151,137
Sippy Downs,113,0,132,0,316011416,113,132
Aroona - Currimundi,94,0,96,0,316021417,94,96
Buddina - Minyama,57,0,48,0,316021418,57,48
Caloundra - Kings Beach,26,0,36,6,316021419,26,42
Caloundra - West,398,7,385,10,NA,405,395
Golden Beach - Pelican Waters,76,4,87,0,316021421,80,87
Moffat Beach - Battery Hill,61,0,83,0,316021422,61,83
Parrearra - Warana,113,0,85,0,316021423,113,85
Wurtulla - Birtinya,122,0,106,0,316021424,122,106
Coolum Beach,184,0,167,3,316031425,184,170
Marcoola - Mudjimba,89,0,85,9,316031426,89,94
Maroochydore - Kuluin,173,0,171,5,316031427,173,176
Mooloolaba - Alexandra Headland,86,3,69,0,316031428,89,69
Noosa Heads,29,0,35,0,316051434,29,35
Noosaville,55,0,56,0,316051435,55,56
Sunshine Beach,67,0,53,5,316051437,67,58
Tewantin,79,0,82,4,316051438,79,86
Peregian Beach - Marcus Beach,36,4,37,0,316051543,40,37
Peregian Springs,170,5,143,0,316051544,175,143
Beerwah,92,0,86,3,316061439,92,89
Caloundra Hinterland,75,0,48,0,316061440,75,48
Glass House Mountains,73,0,64,0,316061441,73,64
Landsborough,178,0,173,8,316061442,178,181
Maroochy Hinterland,42,0,44,5,316061443,42,49
Palmwoods,126,0,112,0,316061444,126,112
Bli Bli,163,0,149,7,316071545,163,156
Diddillibah - Rosemount,33,0,38,3,316071546,33,41
Eumundi - Yandina,115,0,138,0,316071547,115,138
Nambour,231,0,224,8,316071548,231,232
Noosa Hinterland,156,0,195,6,316081549,156,201
Cambooya - Wyreema,101,0,98,0,317011445,101,98
Darling Heights,178,3,184,5,317011446,181,189
Drayton - Harristown,122,0,102,0,317011447,122,102
Gatton,69,0,69,0,317011448,69,69
Gowrie (Qld),84,0,85,0,317011449,84,85
Highfields,165,0,154,0,317011450,165,154
Lockyer Valley - West,115,0,110,8,317011451,115,118
Middle Ridge,63,0,75,3,317011452,63,78
Newtown (Qld),88,0,85,0,317011453,88,85
North Toowoomba - Harlaxton,72,0,61,3,317011454,72,64
Rangeville,72,4,88,0,317011455,76,88
Toowoomba - Central,120,5,150,3,317011456,125,153
Toowoomba - East,97,5,96,5,317011457,102,101
Toowoomba - West,191,3,152,0,317011458,194,152
Wilsonton,134,0,135,8,317011459,134,143
Ayr,74,0,85,5,318011460,74,90
Burdekin,61,0,72,0,318011461,61,72
Charters Towers,62,4,65,5,318011462,66,70
Dalrymple,26,0,35,0,318011463,26,35
Ingham,29,0,42,5,318011464,29,47
Ingham Region,29,0,60,3,NA,29,63
Palm Island,8,0,29,5,318011466,8,34
Aitkenvale,34,0,44,0,318021467,34,44
Annandale,56,0,81,0,NA,56,81
Belgian Gardens - Pallarenda,25,0,34,0,318021469,25,34
Bohle Plains,129,0,104,4,318021470,129,108
Condon - Rasmussen,122,4,120,6,318021471,126,126
Cranbrook,47,0,51,4,318021472,47,55
Deeragun,400,0,422,11,NA,400,433
Douglas,56,0,72,0,318021474,56,72
Garbutt - West End,53,0,55,0,318021475,53,55
Gulliver - Currajong - Vincent,88,0,75,6,318021476,88,81
Heatley,41,3,38,5,318021477,44,43
Hermit Park - Rosslea,36,0,48,5,318021478,36,53
Hyde Park - Pimlico,27,0,48,0,318021479,27,48
Kelso,144,0,120,3,318021480,144,123
Kirwan - East,72,0,83,8,318021481,72,91
Kirwan - West,131,0,152,3,318021482,131,155
Magnetic Island,0,0,0,0,318021483,0,0
Mount Louisa,134,0,148,0,318021484,134,148
Mundingburra,28,0,29,0,318021485,28,29
Northern Beaches,50,0,78,4,318021486,50,82
Oonoonba,87,0,69,0,318021487,87,69
South Townsville - Railway Estate,33,0,50,0,318021488,33,50
Townsville - South,44,0,40,0,318021489,44,40
Townsville City - North Ward,31,0,59,0,318021490,31,59
Wulguru - Roseneath,49,0,34,0,318021491,49,34
Ashfield - Kepnock,76,0,51,0,319011492,76,51
Bargara - Burnett Heads,128,3,133,11,319011493,131,144
Branyan - Kensington,44,0,44,0,319011494,44,44
Bundaberg,47,4,57,5,319011495,51,62
Bundaberg East - Kalkie,69,0,73,3,319011496,69,76
Bundaberg North - Gooburrum,64,0,58,0,319011497,64,58
Bundaberg Region - North,71,0,65,3,NA,71,68
Bundaberg Region - South,72,0,51,3,NA,72,54
Millbank - Avoca,72,0,48,0,319011500,72,48
Svensson Heights - Norville,49,0,57,0,319011501,49,57
Walkervale - Avenell Heights,102,0,88,9,319011502,102,97
Gayndah - Mundubbera,15,0,55,0,319021503,15,55
Gin Gin,24,0,40,0,319021504,24,40
Kingaroy,152,0,127,3,319021505,152,130
Kingaroy Region - North,67,0,82,4,NA,67,86
Kingaroy Region - South,22,0,38,3,NA,22,41
Monto - Eidsvold,5,0,32,3,319021508,5,35
Nanango,53,0,54,5,319021509,53,59
North Burnett,0,0,0,0,319021510,0,0
Cooloola,26,0,27,5,319031511,26,32
Gympie - North,139,3,149,4,319031512,142,153
Gympie - South,73,0,88,3,319031513,73,91
Gympie Region,204,3,196,6,NA,207,202
Kilkivan,0,0,0,0,319031515,0,0
Booral - River Heads,47,0,37,0,319041516,47,37
Craignish - Dundowran Beach,38,0,51,0,319041517,38,51
Pialba - Eli Waters,118,0,136,3,319041518,118,139
Point Vernon,48,0,45,0,319041519,48,45
Torquay - Scarness - Kawungan,110,0,122,0,319041520,110,122
Urangan - Wondunna,98,0,94,5,319041521,98,99
Burrum - Fraser,79,0,74,8,319051522,79,82
Granville,23,0,23,0,319051523,23,23
Maryborough (Qld),155,3,138,13,319051524,158,151
Maryborough Region - South,42,3,57,3,NA,45,60
Tinana,47,0,39,0,319051526,47,39
Migratory - Offshore - Shipping (Qld),0,0,0,0,397979799,0,0
Special purpose codes (Qld),11,0,0,0,NA,11,0
Adelaide,55,0,50,0,401011001,55,50
North Adelaide,20,0,32,0,401011002,20,32
Adelaide Hills,48,0,46,0,401021003,48,46
Aldgate - Stirling,166,0,175,0,401021004,166,175
Hahndorf - Echunga,50,0,47,0,401021005,50,47
Lobethal - Woodside,77,0,96,0,401021006,77,96
Mount Barker,203,0,242,0,401021007,203,242
Mount Barker Region,51,0,70,0,NA,51,70
Nairne,60,0,81,5,401021009,60,86
Uraidla - Summertown,56,0,57,0,401021010,56,57
Burnside - Wattle Park,152,0,188,0,401031011,152,188
Glenside - Beaumont,100,0,99,0,NA,100,99
Toorak Gardens,146,0,173,0,401031013,146,173
Athelstone,82,0,87,0,401041014,82,87
Paradise - Newton,190,0,178,0,401041015,190,178
Rostrevor - Magill,221,0,209,0,401041016,221,209
Norwood (SA),82,0,74,0,401051017,82,74
Payneham - Felixstow,122,0,124,0,401051018,122,124
St Peters - Marden,116,0,90,0,401051019,116,90
Nailsworth - Broadview,52,0,68,0,401061020,52,68
Prospect,157,0,166,0,401061021,157,166
Walkerville,56,0,61,0,401061022,56,61
Goodwood - Millswood,160,0,163,0,401071023,160,163
Unley - Parkside,173,0,190,0,401071024,173,190
Gawler - North,77,0,90,0,402011025,77,90
Gawler - South,190,0,216,5,402011026,190,221
Lewiston - Two Wells,56,0,52,0,402011027,56,52
Craigmore - Blakeview,204,0,263,0,402021028,204,263
Davoren Park,212,0,320,6,402021029,212,326
Elizabeth,59,0,121,0,402021030,59,121
Elizabeth East,114,0,165,3,402021031,114,168
Munno Para West - Angle Vale,233,0,277,3,402021032,233,280
One Tree Hill,17,0,14,0,402021033,17,14
Smithfield - Elizabeth North,86,3,177,3,402021034,89,180
Virginia - Waterloo Corner,55,0,75,0,402021035,55,75
Enfield - Blair Athol,241,3,245,3,402031036,244,248
Northgate - Oakden - Gilles Plains,298,0,301,3,NA,298,304
Windsor Gardens,270,0,273,3,402031038,270,276
Dry Creek - North,0,0,0,0,402041039,0,0
Ingle Farm,124,4,165,5,402041040,128,170
Para Hills,133,0,159,4,402041041,133,163
Parafield,0,0,0,0,402041042,0,0
Parafield Gardens,149,0,242,7,402041043,149,249
Paralowie,150,0,232,4,402041044,150,236
Salisbury,123,0,194,4,402041046,123,198
Salisbury East,148,0,221,3,402041047,148,224
Salisbury North,160,0,256,3,402041048,160,259
Mawson Lakes - Globe Derby Park,128,0,170,0,402041171,128,170
Pooraka - Cavan,56,0,107,4,402041172,56,111
Golden Grove,80,0,90,0,402051049,80,90
Greenwith,85,0,83,0,402051050,85,83
Highbury - Dernancourt,91,0,105,0,402051051,91,105
Hope Valley - Modbury,136,0,158,0,402051052,136,158
Modbury Heights,178,0,179,3,402051053,178,182
Redwood Park,154,0,149,0,402051054,154,149
St Agnes - Ridgehaven,104,0,127,0,402051055,104,127
Brighton (SA),100,0,131,0,403011056,100,131
Glenelg (SA),142,0,135,3,403011057,142,138
Edwardstown,141,0,145,0,403021058,141,145
Hallett Cove,113,0,128,0,403021059,113,128
Marino - Seaview Downs,94,0,114,5,403021060,94,119
Mitchell Park,150,0,133,0,403021061,150,133
Morphettville,164,0,185,0,403021062,164,185
Sheidow Park - Trott Park,128,0,118,0,403021063,128,118
Warradale,157,0,144,0,403021064,157,144
Belair,45,0,43,0,403031065,45,43
Bellevue Heights,59,0,56,0,403031066,59,56
Blackwood,144,0,147,0,403031067,144,147
Colonel Light Gardens,187,0,181,0,403031068,187,181
Mitcham (SA),142,0,152,0,403031069,142,152
Panorama,78,0,82,0,403031070,78,82
Aberfoyle Park,120,0,113,0,403041071,120,113
Aldinga,164,0,153,0,403041072,164,153
Christie Downs,70,0,87,0,403041073,70,87
Christies Beach,69,0,111,0,403041074,69,111
Clarendon,20,0,14,0,403041075,20,14
Coromandel Valley,52,0,52,0,403041076,52,52
Flagstaff Hill,99,0,110,0,403041077,99,110
Hackham - Onkaparinga Hills,53,0,60,0,403041078,53,60
Hackham West - Huntfield Heights,85,0,81,0,403041079,85,81
Happy Valley,139,0,143,0,403041080,139,143
Happy Valley Reservoir,0,0,0,0,403041081,0,0
Lonsdale,0,0,0,0,403041082,0,0
McLaren Vale,72,0,85,0,403041083,72,85
Morphett Vale - East,122,0,130,0,403041084,122,130
Morphett Vale - West,93,0,113,4,403041085,93,117
Reynella,99,0,113,0,403041086,99,113
Seaford (SA),258,5,279,0,NA,263,279
Willunga,22,0,33,0,403041088,22,33
Woodcroft,111,0,100,0,403041089,111,100
Beverley,98,0,86,0,404011090,98,86
Flinders Park,143,0,145,0,404011091,143,145
Henley Beach,127,0,123,0,404011092,127,123
Hindmarsh - Brompton,153,0,143,0,404011093,153,143
Royal Park - Hendon - Albert Park,71,0,62,0,404011094,71,62
Seaton - Grange,154,0,129,0,404011095,154,129
West Lakes,123,0,111,0,404011096,123,111
Woodville - Cheltenham,186,0,161,0,404011097,186,161
Dry Creek - South,0,0,0,0,404021098,0,0
Largs Bay - Semaphore,118,0,142,0,404021099,118,142
North Haven,136,0,123,0,404021100,136,123
Port Adelaide,106,0,100,0,404021101,106,100
The Parks,145,4,141,6,404021102,149,147
Torrens Island,0,0,0,0,404021103,0,0
Adelaide Airport,0,0,0,0,404031104,0,0
Fulham,25,0,24,0,404031105,25,24
Lockleys,100,0,115,4,404031106,100,119
Plympton,221,0,244,0,404031107,221,244
Richmond (SA),139,0,123,3,404031108,139,126
West Beach,51,0,42,0,404031109,51,42
Barossa - Angaston,60,0,54,0,405011110,60,54
Light,84,0,117,3,405011111,84,120
Lyndoch,55,0,64,0,405011112,55,64
Mallala,32,0,27,0,405011113,32,27
Nuriootpa,78,0,44,0,405011114,78,44
Tanunda,50,0,46,0,405011115,50,46
Clare,46,0,28,0,405021116,46,28
Gilbert Valley,25,0,40,0,405021117,25,40
Goyder,15,0,27,0,405021118,15,27
Wakefield - Barunga West,71,0,51,0,405021119,71,51
Jamestown,38,0,37,0,405031120,38,37
Peterborough - Mount Remarkable,26,0,28,0,405031121,26,28
Port Pirie,80,0,128,0,405031122,80,128
Port Pirie Region,22,0,32,0,NA,22,32
Kadina,40,0,65,0,405041124,40,65
Moonta,20,0,40,0,405041125,20,40
Wallaroo,29,0,35,0,405041126,29,35
Yorke Peninsula - North,23,0,55,0,405041127,23,55
Yorke Peninsula - South,15,0,21,0,405041128,15,21
Ceduna,39,6,34,4,406011129,45,38
Eyre Peninsula,67,0,38,0,406011130,67,38
Kimba - Cleve - Franklin Harbour,38,0,27,0,406011131,38,27
Le Hunte - Elliston,3,0,37,0,406011132,3,37
Port Lincoln,115,0,147,9,406011133,115,156
West Coast (SA),15,0,43,3,406011134,15,46
Western,0,0,0,0,406011135,0,0
Whyalla,161,10,227,10,406011136,171,237
Whyalla - North,0,0,0,0,406011137,0,0
APY Lands,41,14,41,16,406021138,55,57
Coober Pedy,17,5,19,3,406021139,22,22
Quorn - Lake Gilles,8,0,27,0,406021140,8,27
Outback,3,0,9,0,406021141,3,9
Port Augusta,120,6,152,9,406021142,126,161
Roxby Downs,89,0,49,0,406021143,89,49
Goolwa - Port Elliot,66,0,77,0,407011144,66,77
Kangaroo Island,45,0,36,0,407011145,45,36
Strathalbyn,70,0,81,0,407011146,70,81
Strathalbyn Region,40,0,64,0,NA,40,64
Victor Harbor,79,0,102,0,407011148,79,102
Yankalilla,44,0,29,0,407011149,44,29
Grant,44,0,48,4,407021150,44,52
Kingston - Robe,23,0,29,0,407021151,23,29
Millicent,37,0,39,0,407021152,37,39
Naracoorte,41,0,39,0,407021154,41,39
Naracoorte Region,14,0,15,0,NA,14,15
Penola,22,0,27,0,407021156,22,27
Tatiara,65,0,33,0,407021157,65,33
Wattle Range,22,0,41,0,407021158,22,41
Mount Gambier - East,124,0,182,0,407021173,124,182
Mount Gambier - West,127,3,137,0,407021174,130,137
Barmera,19,0,53,0,407031159,19,53
Berri,19,0,47,0,407031160,19,47
Karoonda - Lameroo,27,0,20,0,407031161,27,20
Loxton,38,0,64,0,407031162,38,64
Loxton Region,10,0,15,0,NA,10,15
Mannum,24,0,26,0,407031164,24,26
Murray Bridge,192,0,189,5,407031165,192,194
Murray Bridge Region,27,0,23,0,NA,27,23
Renmark,36,0,27,0,407031167,36,27
Renmark Region,42,0,47,0,NA,42,47
The Coorong,30,0,47,5,407031169,30,52
Waikerie,30,0,51,0,407031170,30,51
Migratory - Offshore - Shipping (SA),0,0,0,0,497979799,0,0
Special purpose codes (SA),6,0,9,0,NA,6,9
Augusta,48,0,72,6,501011001,48,78
Busselton,287,3,300,6,NA,290,306
Busselton Region,138,0,156,3,NA,138,159
Margaret River,94,3,114,20,501011004,97,134
Australind - Leschenault,240,3,253,25,501021005,243,278
Capel,28,0,68,7,501021007,28,75
College Grove - Carey Park,37,0,74,8,501021008,37,82
Collie,49,0,85,8,501021009,49,93
Dardanup,12,0,26,0,501021010,12,26
Davenport,0,0,0,0,501021011,0,0
Eaton - Pelican Point,121,0,153,6,501021012,121,159
Harvey,58,0,90,6,501021014,58,96
East Bunbury - Glen Iris,62,0,86,3,501021015,62,89
Waroona,22,0,46,3,501021016,22,49
Dalyellup,96,0,143,16,501021251,96,159
Gelorup - Stratham,29,3,23,0,501021252,32,23
South Bunbury - Bunbury,98,0,117,7,501021253,98,124
Withers - Usher,34,0,64,7,501021254,34,71
Bridgetown - Boyup Brook,37,0,64,0,501031017,37,64
Donnybrook - Balingup,29,0,62,0,501031018,29,62
Manjimup,16,0,71,4,501031019,16,75
Pemberton,22,0,31,0,501031020,22,31
Dawesville - Bouvard,87,3,96,0,502011021,90,96
Falcon - Wannanup,79,0,91,0,502011022,79,91
Greenfields,91,0,93,3,502011023,91,96
Halls Head - Erskine,146,0,192,5,502011024,146,197
Mandurah,54,0,95,0,502011025,54,95
Mandurah - East,34,0,51,3,502011026,34,54
Mandurah - North,187,0,378,14,502011027,187,392
Mandurah - South,70,0,92,5,502011028,70,97
Pinjarra,87,0,106,6,502011029,87,112
City Beach,32,0,45,0,503011030,32,45
Claremont (WA),71,0,115,0,503011031,71,115
Cottesloe,43,0,76,0,503011032,43,76
Floreat,74,0,99,0,503011033,74,99
Mosman Park - Peppermint Grove,63,0,94,7,503011034,63,101
Nedlands - Dalkeith - Crawley,93,4,172,5,503011035,97,177
Swanbourne - Mount Claremont,82,0,106,0,503011036,82,106
Kings Park (WA),0,0,0,0,503021037,0,0
Mount Hawthorn - Leederville,123,0,156,0,503021038,123,156
Mount Lawley - Inglewood,131,3,158,12,503021039,134,170
North Perth,80,0,80,0,503021040,80,80
Perth City,136,0,173,0,NA,136,173
Subiaco - Shenton Park,113,0,179,0,503021042,113,179
Wembley - West Leederville - Glendalough,156,0,243,6,503021043,156,249
Bassendean - Eden Hill - Ashfield,155,0,194,5,504011044,155,199
Bayswater - Embleton - Bedford,237,0,312,19,504011045,237,331
Maylands,91,0,114,5,504011046,91,119
Morley,189,0,276,10,504011047,189,286
Noranda,61,0,75,5,504011048,61,80
Chidlow,11,0,25,0,504021049,11,25
Glen Forrest - Darlington,48,4,77,7,504021050,52,84
Helena Valley - Koongamia,47,0,63,6,504021051,47,69
Malmalling - Reservoir,0,0,0,0,504021052,0,0
Mundaring,78,7,133,13,504021053,85,146
Swan View - Greenmount - Midvale,93,0,135,11,504021054,93,146
Avon Valley National Park,0,0,0,0,504031055,0,0
Ballajura,130,0,239,10,504031056,130,249
Beechboro,218,0,329,16,504031057,218,345
Bullsbrook,54,0,60,0,504031058,54,60
Ellenbrook,499,7,813,58,504031300,506,871
Gidgegannup,11,0,18,0,504031060,11,18
Hazelmere - Guildford,40,0,91,4,504031061,40,95
Lockridge - Kiara,125,0,220,7,504031062,125,227
Malaga,0,0,0,0,504031063,0,0
Melaleuca - Lexia,0,0,0,0,504031064,0,0
Middle Swan - Herne Hill,46,0,67,3,504031065,46,70
Midland - Guildford,73,0,91,0,504031066,73,91
Stratton - Jane Brook,75,3,103,0,504031067,78,103
The Vines,124,3,196,12,504031068,127,208
Walyunga National Park,0,0,0,0,504031069,0,0
Craigie - Beldon,136,0,145,7,505011070,136,152
Currambine - Kinross,102,0,148,0,505011071,102,148
Duncraig,141,0,181,5,505011072,141,186
Greenwood - Warwick,113,0,173,9,505011073,113,182
Heathridge - Connolly,107,0,130,3,505011074,107,133
Hillarys,68,0,120,0,505011075,68,120
Iluka - Burns Beach,40,0,101,0,505011076,40,101
Joondalup - Edgewater,111,0,132,9,505011077,111,141
Kingsley,116,3,153,8,505011078,119,161
Mullaloo - Kallaroo,79,0,115,4,505011079,79,119
Ocean Reef,81,0,73,5,505011080,81,78
Padbury,127,0,110,3,505011081,127,113
Sorrento - Marmion,71,0,115,5,505011082,71,120
Woodvale,70,0,95,6,505011083,70,101
Balcatta - Hamersley,142,0,176,0,505021084,142,176
Balga - Mirrabooka,163,0,303,21,505021085,163,324
Dianella,190,0,253,4,NA,190,257
Herdsman,0,0,0,0,505021087,0,0
Innaloo - Doubleview,201,4,211,8,505021088,205,219
Karrinyup - Gwelup - Carine,255,5,316,5,505021089,260,321
Nollamara - Westminster,161,0,246,15,505021090,161,261
Osborne Park Industrial,0,0,0,0,505021091,0,0
Scarborough,150,5,166,3,505021092,155,169
Stirling - Osborne Park,96,0,142,4,505021093,96,146
Trigg - North Beach - Watermans Bay,68,0,76,6,505021094,68,82
Tuart Hill - Joondanna,89,4,106,0,505021095,93,106
Wembley Downs - Churchlands - Woodlands,109,0,153,4,505021096,109,157
Yokine - Coolbinia - Menora,113,0,157,3,505021097,113,160
Alexander Heights - Koondoola,82,0,135,8,505031098,82,143
Butler - Merriwa - Ridgewood,262,0,320,19,505031099,262,339
Carramar,241,0,319,8,505031100,241,327
Clarkson,160,0,208,5,505031101,160,213
Girrawheen,59,0,122,10,505031102,59,132
Madeley - Darch - Landsdale,322,0,450,30,NA,322,480
Marangaroo,95,0,113,3,505031104,95,116
Mindarie - Quinns Rocks - Jindalee,157,0,218,9,505031105,157,227
Neerabup National Park,0,0,0,0,505031106,0,0
Tapping - Ashby - Sinagra,179,0,169,6,505031107,179,175
Wanneroo,305,3,418,10,NA,308,428
Alkimos - Eglinton,201,0,281,15,505031255,201,296
Carabooda - Pinjar,0,0,4,0,505031256,0,4
Two Rocks,49,0,59,3,505031257,49,62
Yanchep,149,0,193,3,505031258,149,196
Armadale - Wungong - Brookdale,243,3,345,16,506011110,246,361
Ashendon - Lesley,0,0,0,0,506011111,0,0
Camillo - Champion Lakes,56,0,114,7,506011112,56,121
Forrestdale - Harrisdale - Piara Waters,358,4,628,31,NA,362,659
Kelmscott,79,0,92,9,506011114,79,101
Mount Nasura - Mount Richon - Bedfordale,44,0,92,11,506011115,44,103
Roleystone,41,0,75,0,506011116,41,75
Seville Grove,132,0,174,13,506011117,132,187
Belmont - Ascot - Redcliffe,87,0,152,7,506021118,87,159
East Victoria Park - Carlisle,179,0,191,5,506021119,179,196
Kewdale Commercial,0,0,0,0,506021120,0,0
Perth Airport,0,0,0,0,506021121,0,0
Rivervale - Kewdale - Cloverdale,195,0,261,16,NA,195,277
Victoria Park - Lathlain - Burswood,128,0,171,0,506021123,128,171
Bentley - Wilson - St James,134,0,159,14,506031124,134,173
Canning Vale - West,53,0,109,3,506031125,53,112
Canning Vale Commercial,0,0,0,0,506031126,0,0
Cannington - Queens Park,181,0,300,0,506031127,181,300
Parkwood - Ferndale - Lynwood,106,0,176,12,506031128,106,188
Riverton - Shelley - Rossmoyne,89,0,142,0,506031129,89,142
Welshpool,0,0,0,0,506031130,0,0
Willetton,139,4,213,7,506031131,143,220
Beckenham - Kenwick - Langford,148,0,290,20,506041132,148,310
Canning Vale - East,172,0,331,10,506041133,172,341
Gosnells,176,0,261,16,506041134,176,277
Huntingdale - Southern River,199,0,355,15,506041135,199,370
Maddington - Orange Grove - Martin,120,0,205,9,506041136,120,214
Thornlie,158,0,295,22,506041137,158,317
Forrestfield - Wattle Grove,199,3,292,11,506051138,202,303
High Wycombe,108,0,154,8,506051139,108,162
Kalamunda - Maida Vale - Gooseberry Hill,100,0,112,6,506051140,100,118
Lesmurdie - Bickley - Carmel,70,0,132,11,506051141,70,143
Byford,314,5,385,26,506061142,319,411
Mundijong,71,3,112,3,506061143,74,115
Serpentine - Jarrahdale,24,0,36,3,506061144,24,39
Como,99,0,121,0,506071145,99,121
Manning - Waterford,100,0,115,0,506071146,100,115
South Perth - Kensington,165,0,211,10,506071147,165,221
Banjup,259,0,336,12,507011148,259,348
Bibra Industrial,0,0,0,0,507011150,0,0
Bibra Lake,0,0,0,0,507011151,0,0
Coogee,97,0,116,12,507011152,97,128
Coolbellup,64,3,80,5,507011153,67,85
Hamilton Hill,84,0,116,3,507011154,84,119
Henderson,0,0,0,0,507011155,0,0
North Coogee,22,0,37,0,507011158,22,37
South Lake - Cockburn Central,96,4,124,9,507011159,100,133
Spearwood,103,3,122,10,507011160,106,132
Success - Hammond Park,212,3,302,17,507011161,215,319
Yangebup,85,5,131,10,507011163,90,141
Beeliar - Wattleup,128,0,143,7,507011259,128,150
Jandakot,13,0,14,0,507011260,13,14
East Fremantle,60,0,71,0,507021164,60,71
Fremantle,103,0,145,0,507021165,103,145
Fremantle - South,166,3,179,3,507021166,169,182
O'Connor (WA),0,0,0,0,507021167,0,0
Bertram - Wellard (West),266,4,334,13,NA,270,347
Calista,46,0,100,5,507031170,46,105
Hope Valley - Postans,0,0,0,0,507031172,0,0
Kwinana Industrial,0,0,0,0,507031173,0,0
Parmelia - Orelia,110,0,161,3,507031174,110,164
Casuarina - Wandi,110,0,157,8,507031261,110,165
Applecross - Ardross,86,0,131,0,507041175,86,131
Bateman,31,0,43,3,507041176,31,46
Bicton - Palmyra,139,0,154,0,507041177,139,154
Booragoon,128,3,145,4,507041178,131,149
Bull Creek,52,0,96,5,507041179,52,101
Leeming,99,0,125,0,507041180,99,125
Melville,147,7,185,9,507041181,154,194
Murdoch - Kardinya,85,0,99,10,507041182,85,109
Willagee,55,0,46,0,507041183,55,46
Winthrop,39,0,59,3,507041184,39,62
Baldivis,504,0,706,39,NA,504,745
Cooloongup,52,0,86,5,507051186,52,91
Port Kennedy,145,0,171,10,507051187,145,181
Rockingham,101,0,129,13,507051188,101,142
Rockingham Lakes,0,0,0,0,507051189,0,0
Safety Bay - Shoalwater,100,0,95,6,507051190,100,101
Singleton - Golden Bay - Secret Harbour,234,0,328,6,507051191,234,334
Waikiki,83,0,136,8,507051192,83,144
Warnbro,80,0,148,13,507051193,80,161
Albany,111,0,123,6,509011225,111,129
Albany Region,21,0,44,0,NA,21,44
Bayonet Head - Lower King,33,0,48,0,509011227,33,48
Denmark,55,0,74,4,509011228,55,78
Gnowangerup,23,0,38,4,509011229,23,42
Katanning,27,0,52,3,509011230,27,55
Kojonup,21,0,47,3,509011231,21,50
Little Grove - Elleker,14,0,15,5,509011232,14,20
McKail - Willyung,98,0,159,8,509011233,98,167
Plantagenet,23,0,50,6,509011234,23,56
Stirling Range National Park,0,0,0,0,509011235,0,0
Chittering,41,0,63,5,509021236,41,68
Cunderdin,15,0,40,0,509021237,15,40
Dowerin,29,0,48,0,509021238,29,48
Gingin - Dandaragan,49,0,92,0,509021239,49,92
Merredin,20,0,61,4,509021240,20,65
Moora,20,0,54,6,509021241,20,60
Mukinbudin,11,4,31,0,509021242,15,31
Northam,58,3,117,4,509021243,61,121
Toodyay,22,0,41,0,509021244,22,41
York - Beverley,27,0,42,9,509021245,27,51
Brookton,34,0,38,5,509031246,34,43
Kulin,34,0,67,0,509031247,34,67
Murray,18,0,38,0,509031248,18,38
Narrogin,11,0,54,4,509031249,11,58
Wagin,32,0,54,0,509031250,32,54
Broome,137,0,207,16,510011262,137,223
Derby - West Kimberley,28,0,102,22,510011263,28,124
Halls Creek,3,3,35,21,510011264,6,56
Kununurra,41,0,92,14,510011265,41,106
Roebuck,7,0,22,9,510011266,7,31
East Pilbara,0,0,0,0,510021267,0,0
Newman,32,0,103,3,510021268,32,106
Port Hedland,49,0,78,5,510021269,49,83
South Hedland,62,0,179,17,510021270,62,196
Ashburton (WA),60,0,136,5,510031271,60,141
Karratha,188,0,329,11,510031272,188,340
Roebourne,41,0,77,8,510031273,41,85
Esperance,83,0,159,14,511011274,83,173
Esperance Region,41,0,49,0,NA,41,49
Carnarvon,41,0,69,8,511021276,41,77
Exmouth,20,0,41,0,511021277,20,41
Boulder,48,0,109,4,511031278,48,113
Kalgoorlie,93,5,200,16,511031279,98,216
Kalgoorlie - North,90,0,158,11,511031280,90,169
Kalgoorlie Airport,0,0,0,0,511031281,0,0
Kambalda - Coolgardie - Norseman,12,0,48,5,511031282,12,53
Leinster - Leonora,20,0,29,15,511031283,20,44
Trafalgar (WA),0,0,0,0,511031284,0,0
Geraldton,49,0,114,11,511041285,49,125
Geraldton - East,44,0,88,8,511041286,44,96
Geraldton - North,71,0,118,4,511041287,71,122
Geraldton - South,81,0,132,4,511041288,81,136
Irwin,15,0,35,0,511041289,15,35
Meekatharra,0,0,28,6,511041290,0,34
Morawa,20,0,48,6,511041291,20,54
Northampton - Mullewa - Greenough,18,0,55,3,511041292,18,58
Migratory - Offshore - Shipping (WA),0,0,0,0,597979799,0,0
Special purpose codes (WA),0,0,0,0,NA,0,0
Bridgewater - Gagebrook,88,0,146,0,601011001,88,146
Brighton - Pontville,80,0,99,0,601011002,80,99
Old Beach - Otago,57,0,68,0,601011003,57,68
Bellerive - Rosny,68,0,65,0,601021004,68,65
Cambridge,167,0,159,3,601021005,167,162
Geilston Bay - Risdon,40,0,41,0,601021006,40,41
Howrah - Tranmere,136,0,122,0,601021007,136,122
Lindisfarne - Rose Bay,87,0,81,0,601021008,87,81
Mornington - Warrane,57,0,47,0,601021009,57,47
Risdon Vale,21,0,54,0,601021010,21,54
Rokeby,86,0,123,0,601021011,86,123
South Arm,0,0,0,0,601021012,0,0
Austins Ferry - Granton,44,0,55,0,601031013,44,55
Berriedale - Chigwell,50,0,79,0,601031014,50,79
Claremont (Tas.),56,0,110,0,601031015,56,110
Derwent Park - Lutana,35,0,57,0,601031016,35,57
Glenorchy,81,0,107,0,601031017,81,107
Montrose - Rosetta,36,0,70,0,601031018,36,70
Moonah,32,0,70,5,601031019,32,75
New Norfolk,63,0,83,0,601031020,63,83
West Moonah,40,0,56,0,601031021,40,56
Kingston - Huntingfield,153,0,150,0,601041022,153,150
Kingston Beach - Blackmans Bay,128,0,99,3,601041023,128,102
Margate - Snug,112,0,133,0,601041024,112,133
Mount Wellington,0,0,0,0,601041025,0,0
Taroona - Bonnet Hill,33,0,29,0,601041026,33,29
Hobart,63,0,43,0,601051027,63,43
Lenah Valley - Mount Stuart,127,0,107,0,601051028,127,107
Mount Nelson - Dynnyrne,56,0,49,0,601051029,56,49
New Town,65,0,49,0,601051030,65,49
Sandy Bay,87,0,130,0,601051031,87,130
South Hobart - Fern Tree,70,0,71,3,601051032,70,74
West Hobart,61,0,59,0,601051033,61,59
Dodges Ferry - Lewisham,80,0,99,3,601061034,80,102
Sorell - Richmond,110,0,130,0,601061035,110,130
Invermay,24,0,34,0,602011036,24,34
Kings Meadows - Punchbowl,45,0,49,0,602011037,45,49
Launceston,33,0,39,0,602011038,33,39
Legana,50,0,44,0,602011039,50,44
Mowbray,26,0,56,0,602011040,26,56
Newnham - Mayfield,75,0,125,6,602011041,75,131
Newstead,66,0,43,3,602011042,66,46
Norwood (Tas.),45,0,46,4,602011043,45,50
Prospect Vale - Blackstone,57,0,73,0,602011044,57,73
Ravenswood,31,0,71,3,602011045,31,74
Riverside,52,0,87,0,602011046,52,87
South Launceston,54,0,57,0,602011047,54,57
Summerhill - Prospect,56,0,69,0,602011048,56,69
Trevallyn,41,0,58,0,602011049,41,58
Waverley - St Leonards,39,0,51,0,602011050,39,51
West Launceston,33,0,50,0,602011051,33,50
Youngtown - Relbia,56,0,68,0,602011052,56,68
Beauty Point - Beaconsfield,19,0,36,0,602021053,19,36
Deloraine,32,0,57,0,602021054,32,57
Grindelwald - Lanena,44,0,65,0,602021055,44,65
Hadspen - Carrick,37,0,55,0,602021056,37,55
Westbury,24,0,35,0,602021057,24,35
Dilston - Lilydale,50,0,51,0,602031058,50,51
George Town,48,0,76,0,602031059,48,76
Longford,29,0,51,5,602031060,29,56
Northern Midlands,33,0,36,5,602031061,33,41
Perth - Evandale,61,0,65,0,602031062,61,65
St Helens - Scamander,40,0,56,8,602031064,40,64
Flinders and Cape Barren Islands,0,0,0,0,602031099,0,0
Scottsdale - Bridport,62,0,72,0,602031100,62,72
Central Highlands,0,0,0,0,603011065,0,0
Derwent Valley,26,0,30,0,603011066,26,30
Southern Midlands,56,0,101,3,603011067,56,104
Wilderness - East,0,0,0,0,603011068,0,0
Bruny Island - Kettering,12,0,39,0,603021069,12,39
Cygnet,39,0,46,0,603021070,39,46
Geeveston - Dover,27,0,38,0,603021071,27,38
Huonville - Franklin,97,0,114,0,603021072,97,114
Forestier - Tasman,0,0,0,0,603031073,0,0
Triabunna - Bicheno,33,0,62,0,603031074,33,62
Acton - Upper Burnie,35,0,41,0,604011075,35,41
Burnie - Ulverstone Region,40,0,45,0,NA,40,45
Burnie - Wivenhoe,32,0,48,0,604011077,32,48
Parklands - Camdale,46,0,97,0,604011078,46,97
Penguin - Sulphur Creek,44,0,61,0,604011079,44,61
Romaine - Havenview,42,0,45,0,604011080,42,45
Somerset,39,0,34,0,604011081,39,34
Ulverstone,63,0,84,0,604011082,63,84
West Ulverstone,43,0,33,0,604011083,43,33
Wynyard,52,0,72,0,604011084,52,72
Devonport,136,0,143,0,604021085,136,143
East Devonport,38,0,63,0,604021086,38,63
Latrobe,35,0,46,0,604021087,35,46
Miandetta - Don,35,0,52,0,604021088,35,52
Port Sorell,56,0,70,0,604021089,56,70
Quoiba - Spreyton,20,0,45,0,604021090,20,45
Sheffield - Railton,25,0,49,0,604021091,25,49
Turners Beach - Forth,30,0,38,0,604021092,30,38
King Island,26,0,17,0,604031093,26,17
North West,31,0,67,0,604031094,31,67
Smithton,43,0,40,0,604031095,43,40
Waratah,31,0,44,0,604031096,31,44
West Coast (Tas.),12,0,41,0,604031097,12,41
Wilderness - West,0,0,0,0,604031098,0,0
Migratory - Offshore - Shipping (Tas.),0,0,0,0,697979799,0,0
Special purpose codes (Tas.),0,0,0,0,NA,0,0
Darwin Airport,0,0,0,0,701011001,0,0
Darwin City,29,0,33,0,701011002,29,33
East Point,0,0,0,0,701011003,0,0
Fannie Bay - The Gardens,28,0,32,0,701011004,28,32
Larrakeyah,22,0,41,0,701011005,22,41
Ludmilla - The Narrows,27,0,31,0,701011006,27,31
Parap,32,0,38,0,701011007,32,38
Stuart Park,35,0,43,0,701011008,35,43
Woolner - Bayview - Winnellie,26,0,26,0,701011009,26,26
Alawa,19,0,29,0,701021010,19,29
Anula,30,0,42,0,701021011,30,42
Berrimah,9,0,14,0,701021012,9,14
Brinkin - Nakara,15,0,35,3,701021013,15,38
Buffalo Creek,0,0,0,0,701021014,0,0
Charles Darwin,0,0,0,0,701021015,0,0
Coconut Grove,30,0,28,4,701021016,30,32
East Arm,0,0,0,0,701021017,0,0
Jingili,18,0,30,0,701021018,18,30
Karama,42,0,62,3,701021019,42,65
Leanyer,48,0,58,4,701021020,48,62
Lyons (NT),90,0,95,3,701021021,90,98
Malak - Marrara,38,0,58,0,701021022,38,58
Millner,18,0,35,4,701021023,18,39
Moil,8,0,21,5,701021024,8,26
Nightcliff,30,5,49,0,701021025,35,49
Rapid Creek,30,0,47,3,701021026,30,50
Tiwi,24,0,24,0,701021027,24,24
Wagaman,17,0,31,0,701021028,17,31
Wanguri,24,0,24,3,701021029,24,27
Wulagi,32,0,35,0,701021030,32,35
Howard Springs,30,0,37,4,701031031,30,41
Humpty Doo,104,0,100,3,701031032,104,103
Koolpinyah,0,0,0,0,701031033,0,0
Virginia,26,0,33,3,701031034,26,36
Weddell,33,0,55,3,701031035,33,58
Bakewell,41,0,51,7,701041036,41,58
Driver,37,0,46,3,701041037,37,49
Durack - Marlow Lagoon,73,0,65,0,701041038,73,65
Gray,25,0,39,3,701041039,25,42
Moulden,32,5,57,9,701041040,37,66
Palmerston - North,63,0,88,0,701041041,63,88
Palmerston - South,129,0,126,6,701041042,129,132
Rosebery - Bellamack,88,0,121,7,701041043,88,128
Woodroffe,40,0,51,3,701041044,40,54
Charles,39,4,46,9,702011045,43,55
East Side,43,0,70,10,702011046,43,80
Flynn (NT),42,0,56,9,702011047,42,65
Larapinta,69,0,72,8,702011048,69,80
Mount Johns,30,0,43,4,702011049,30,47
Petermann - Simpson,9,0,9,0,702011050,9,9
Ross,29,0,20,3,702011051,29,23
Sandover - Plenty,18,0,40,18,702011052,18,58
Tanami,10,8,18,14,702011053,18,32
Yuendumu - Anmatjere,11,4,18,7,702011054,15,25
Barkly,16,5,24,16,702021055,21,40
Tennant Creek,14,0,28,5,702021056,14,33
Alligator,23,4,42,7,702031057,27,49
Daly,11,0,16,4,702031058,11,20
Thamarrurr,5,0,17,7,702031059,5,24
Tiwi Islands,24,5,34,6,702031060,29,40
West Arnhem,18,12,22,27,702031061,30,49
Anindilyakwa,15,0,30,12,702041062,15,42
East Arnhem,46,38,47,48,702041063,84,95
Nhulunbuy,57,0,56,12,702041064,57,68
Elsey,14,3,21,5,702051065,17,26
Gulf,14,0,39,26,702051066,14,65
Katherine,92,3,128,8,702051067,95,136
Victoria River,3,0,24,12,702051068,3,36
Migratory - Offshore - Shipping (NT),0,0,0,0,797979799,0,0
Special purpose codes (NT),0,0,0,0,NA,0,0
Aranda,26,0,39,0,801011001,26,39
Belconnen,52,0,55,0,801011002,52,55
Bruce,73,0,44,0,801011003,73,44
Charnwood,49,0,33,0,801011004,49,33
Cook,39,0,32,0,801011005,39,32
Dunlop,94,4,125,3,801011006,98,128
Evatt,86,0,77,5,801011007,86,82
Florey,49,0,61,0,801011008,49,61
Flynn (ACT),55,0,43,0,801011009,55,43
Fraser,32,0,22,0,801011010,32,22
Giralang,49,0,36,0,801011011,49,36
Gooromon,0,0,0,0,801011012,0,0
Hawker,22,0,23,0,801011013,22,23
Higgins,50,0,35,0,801011014,50,35
Holt,74,0,72,4,801011015,74,76
Kaleen,96,0,105,0,801011016,96,105
Latham,39,0,66,0,801011017,39,66
Lawson,28,0,20,0,801011018,28,20
Macgregor (ACT),119,0,124,0,801011019,119,124
Macquarie,47,0,30,0,801011020,47,30
McKellar,32,0,32,0,801011021,32,32
Melba,48,0,51,0,801011022,48,51
Page,47,0,38,0,801011023,47,38
Scullin,49,0,55,0,801011024,49,55
Spence,30,0,36,3,801011025,30,39
Weetangera,31,0,28,0,801011026,31,28
Molonglo Corridor,0,0,0,0,801011111,0,0
West Belconnen,14,0,9,0,801011144,14,9
Hume,0,0,0,0,801031031,0,0
Kowen,0,0,0,0,801031032,0,0
Canberra East,7,0,6,0,801031113,7,6
Canberra Airport,0,0,0,0,801031114,0,0
Majura,3,0,0,0,801031115,3,0
Amaroo,91,3,76,0,801041034,94,76
Bonner,110,0,156,0,801041035,110,156
Casey,136,0,144,3,801041036,136,147
Crace,126,0,108,4,801041037,126,112
Forde,78,0,66,0,801041038,78,66
Franklin,133,0,100,0,801041039,133,100
Gungahlin,86,0,98,3,801041040,86,101
Hall,0,0,8,0,801041043,0,8
Harrison,124,3,133,0,801041044,127,133
Mitchell,0,0,0,0,801041045,0,0
Ngunnawal,180,0,208,3,801041046,180,211
Nicholls,73,0,75,5,801041047,73,80
Palmerston,88,0,77,0,801041048,88,77
Gungahlin - East,0,0,0,0,801041116,0,0
Gungahlin - West,0,0,0,0,801041117,0,0
Jacka,14,0,15,0,801041118,14,15
Kenny,0,0,0,0,801041119,0,0
Moncrieff,118,0,128,3,801041120,118,131
Taylor,39,0,45,0,801041121,39,45
Throsby,50,0,52,0,801041122,50,52
Acton,5,0,0,0,801051049,5,0
Ainslie,63,0,69,0,801051050,63,69
Braddon,33,0,19,0,801051051,33,19
Civic,14,0,10,0,801051053,14,10
Dickson,29,0,26,0,801051054,29,26
Downer,51,0,59,3,801051055,51,62
Hackett,49,0,30,0,801051056,49,30
Lyneham,45,0,41,0,801051057,45,41
O'Connor (ACT),38,0,65,0,801051058,38,65
Turner,16,0,21,0,801051060,16,21
Watson,115,0,86,0,801051061,115,86
Black Mountain,0,0,0,0,801051123,0,0
Campbell,49,0,26,0,801051124,49,26
Duntroon,11,0,6,0,801051125,11,6
Parkes (ACT) - North,0,0,0,0,801051126,0,0
Reid,8,0,12,0,801051127,8,12
Russell,0,0,0,0,801051128,0,0
Deakin,31,0,33,0,801061062,31,33
Forrest,8,5,8,0,801061063,13,8
Griffith (ACT),38,0,29,0,801061064,38,29
Lake Burley Griffin,0,0,0,0,801061066,0,0
Narrabundah,93,0,74,0,801061067,93,74
Parkes (ACT) - South,0,0,0,0,801061068,0,0
Red Hill (ACT),28,0,27,0,801061069,28,27
Yarralumla,38,0,36,0,801061070,38,36
Barton,16,0,9,0,801061129,16,9
Fyshwick,0,0,0,0,801061130,0,0
Kingston (ACT),45,0,45,0,801061131,45,45
Banks,73,0,67,0,801071071,73,67
Bonython,34,0,64,0,801071072,34,64
Calwell,94,0,65,0,801071073,94,65
Chisholm,77,0,74,3,801071074,77,77
Conder,50,0,75,0,801071075,50,75
Fadden,40,0,43,0,801071076,40,43
Gilmore,51,0,32,0,801071077,51,32
Gordon (ACT),100,0,109,0,801071078,100,109
Gowrie (ACT),60,0,38,0,801071079,60,38
Greenway,30,0,35,0,801071080,30,35
Isabella Plains,68,0,66,0,801071081,68,66
Kambah,149,0,178,0,801071082,149,178
Macarthur,25,0,18,0,801071083,25,18
Monash,75,0,71,0,801071084,75,71
Mount Taylor,0,0,0,0,801071085,0,0
Oxley (ACT),19,0,20,0,801071086,19,20
Richardson,41,0,33,0,801071087,41,33
Theodore,48,0,58,0,801071088,48,58
Tuggeranong,0,0,0,0,801071089,0,0
Wanniassa,92,0,104,0,801071090,92,104
Tuggeranong - West,0,0,0,0,801071132,0,0
Chapman,26,0,34,0,801081091,26,34
Duffy,40,0,44,0,801081092,40,44
Fisher,44,0,35,5,801081093,44,40
Holder,30,0,40,3,801081094,30,43
Rivett,56,0,55,0,801081095,56,55
Stirling,20,0,24,0,801081096,20,24
Waramanga,41,0,34,0,801081097,41,34
Weston,52,0,46,0,801081098,52,46
Scrivener,0,0,0,0,801081133,0,0
Chifley,37,0,31,0,801091099,37,31
Curtin,90,0,64,0,801091100,90,64
Farrer,33,0,40,0,801091101,33,40
Garran,29,0,61,4,801091102,29,65
Hughes,34,0,40,0,801091103,34,40
Isaacs,21,0,18,0,801091104,21,18
Lyons (ACT),35,0,41,0,801091105,35,41
Mawson,32,0,41,0,801091106,32,41
O'Malley,3,0,4,0,801091107,3,4
Pearce,22,0,33,0,801091108,22,33
Phillip,27,0,34,0,801091109,27,34
Torrens,28,0,21,0,801091110,28,21
Arboretum,0,0,0,0,801101134,0,0
Coombs,80,0,99,0,801101135,80,99
Denman Prospect,45,0,43,0,801101136,45,43
Molonglo,0,0,0,0,801101137,0,0
Molonglo - North,0,0,0,0,NA,0,0
Wright,48,0,66,5,801101139,48,71
ACT - South West,9,0,15,0,801111140,9,15
Namadgi,0,0,0,0,801111141,0,0
Migratory - Offshore - Shipping (ACT),0,0,0,0,897979799,0,0
Special purpose codes (ACT),0,0,17,0,NA,0,17
Christmas Island,12,0,17,3,901011001,12,20
Cocos (Keeling) Islands,0,0,3,0,901021002,0,3
Jervis Bay,4,0,5,0,901031003,4,5
Norfolk Island,0,0,0,0,901041004,0,0
Migratory - Offshore - Shipping (OT),0,0,0,0,997979799,0,0
Special purpose codes(OT),0,0,0,0,NA,0,0
